Monster Hunter Rise: Sunbreak - Monster Hunter Rise: Sunbreak
Mega Man Zero/ZX: Legacy Collection - Mega Man Zero/ZX: Legacy Collection
Final Fantasy X/X-2 HD Remaster - Final Fantasy X/X-2 HD Remaster
Umineko no Naku Koro ni Chiru: Episode 5 - End of the Golden Witch - Umineko no Naku Koro ni Chiru: Episode 5 - End of the Golden Witch
Fate/hollow ataraxia - Fate/hollow ataraxia
Project M - Project M
Fate/Stay Night: Réalta Nua Heaven's Feel - Fate/Stay Night: Réalta Nua Heaven's Feel
Persona 3 Portable - Persona 3 Portable
Umineko no Naku Koro ni Chiru: Episode 6 - Dawn of the Golden Witch - Umineko no Naku Koro ni Chiru: Episode 6 - Dawn of the Golden Witch
Fate/stay night - Fate/stay night
Fate/Stay Night: Réalta Nua Unlimited Blade Works - Fate/Stay Night: Réalta Nua Unlimited Blade Works
Resident Evil 4 VR - Resident Evil 4 VR
Destiny: The Taken King - Destiny: The Taken King
Anatomy - Anatomy
StarCraft II: Heart of the Swarm - StarCraft II: Heart of the Swarm
PictoChat - PictoChat
Super Mario Bros. / Duck Hunt - Super Mario Bros. / Duck Hunt
Fate/Stay Night: Réalta Nua Fate - Fate/Stay Night: Réalta Nua Fate
Circle of Blood - Circle of Blood
Umineko no Naku Koro ni: Episode 1 - Legend of the Golden Witch - Umineko no Naku Koro ni: Episode 1 - Legend of the Golden Witch
The Room: Old Sins - The Room: Old Sins
My House - My House
Yo-Kai Watch 2: Bony Spirits / Fleshy Souls - Yo-Kai Watch 2: Bony Spirits / Fleshy Souls
.Hack//G.U. Last Recode - .Hack//G.U. Last Recode
The Witch's House - The Witch's House
Mother 1+2 - Mother 1+2
Planetarian: The Reverie of a Little Planet - Planetarian: The Reverie of a Little Planet
Broken Sword: The Smoking Mirror - Broken Sword: The Smoking Mirror
Trials Evolution - Trials Evolution
Needy Streamer Overload - Needy Streamer Overload
Lichess - Lichess
Monolith - Monolith
Split/Second - Split/Second
Mystic Messenger - Mystic Messenger
WCW/nWo Revenge - WCW/nWo Revenge
.Hack//G.U. Vol. 3: Redemption - .Hack//G.U. Vol. 3: Redemption
Faith - Faith
Pictopix - Pictopix
.Hack//G.U. Vol. 2: Reminisce - .Hack//G.U. Vol. 2: Reminisce
Shenzhen I/O - Shenzhen I/O
Northern Journey - Northern Journey
Control: The Foundation - Control: The Foundation
Fate/Extra - Fate/Extra
Kingdom Hearts 358/2 Days - Kingdom Hearts 358/2 Days
.Hack//Outbreak - .Hack//Outbreak
Journey: Collector's Edition - Journey: Collector's Edition
.Hack//Infection - .Hack//Infection
.Hack//Mutation - .Hack//Mutation
.Hack//G.U. Vol. 1: Rebirth - .Hack//G.U. Vol. 1: Rebirth
.Hack//Quarantine - .Hack//Quarantine
Zero: Tsukihami no Kamen - Zero: Tsukihami no Kamen
Poptropica - Poptropica
Fate/unlimited codes - Fate/unlimited codes
Ridiculous Fishing - Ridiculous Fishing
Stranglehold - Stranglehold
The Last Door - The Last Door
Cube Escape: Seasons - Cube Escape: Seasons
Flashback: The Quest for Identity - Flashback: The Quest for Identity
The Sims 3: University Life - The Sims 3: University Life
The Beast Within: A Gabriel Knight Mystery - The Beast Within: A Gabriel Knight Mystery
Analogue: A Hate Story - Analogue: A Hate Story
Little Nightmares: The Residence - Little Nightmares: The Residence
Project Kat: Paper Lily Prologue - Project Kat: Paper Lily Prologue
Guild Wars: Nightfall - Guild Wars: Nightfall
Tomorrow Won't Come For Those Without - Tomorrow Won't Come For Those Without
Snow Bros. - Snow Bros.
Snake - Snake
Doodle Champion Island Games - Doodle Champion Island Games
The Sims 3: Supernatural - The Sims 3: Supernatural
The Sims 3: Late Night - The Sims 3: Late Night
¡Shin Chan: Flipa en colores! - ¡Shin Chan: Flipa en colores!
Device 6 - Device 6
3D Sonic the Hedgehog 2 - 3D Sonic the Hedgehog 2
Fate/Extella Link - Fate/Extella Link
Sephonie - Sephonie
Cube Escape: Theatre - Cube Escape: Theatre
Cube Escape: Case 23 - Cube Escape: Case 23
Letreco - Letreco
The Kingdom of Loathing - The Kingdom of Loathing
Little Nightmares: The Depths - Little Nightmares: The Depths
Petal Crash - Petal Crash
I Am Dead - I Am Dead
Bleed - Bleed
The Sims 3: Ambitions - The Sims 3: Ambitions
Nancy Drew: Last Train to Blue Moon Canyon - Nancy Drew: Last Train to Blue Moon Canyon
Little Nightmares: The Hideaway - Little Nightmares: The Hideaway
​The Ninja Saviors: Return of the Warriors - ​The Ninja Saviors: Return of the Warriors
3D Sonic the Hedgehog - 3D Sonic the Hedgehog
Breakout - Breakout
duplicate Trace Memory - duplicate Trace Memory
Touch Detective 2 1/2 - Touch Detective 2 1/2
Termo - Termo
The Black Mirror - The Black Mirror
Tiny Wings - Tiny Wings
The Sims: Livin' Large - The Sims: Livin' Large
Receiver 2 - Receiver 2
Feel the Magic: XY/XX - Feel the Magic: XY/XX
The Closing Shift - The Closing Shift
Guess the Game - Guess the Game
Kahoot! - Kahoot!
DDTank - DDTank
Command & Conquer: Remastered - Command & Conquer: Remastered
Narcissu - Narcissu
The NewZealand Story - The NewZealand Story
Holedown - Holedown
Cube Escape: Harvey's Box - Cube Escape: Harvey's Box
Problem Attic - Problem Attic
Cloudbuilt - Cloudbuilt
AdventureQuest Worlds - AdventureQuest Worlds
Hustle Cat - Hustle Cat
Fate/Extella: The Umbral Star - Fate/Extella: The Umbral Star
Championship Manager: Season 01/02 - Championship Manager: Season 01/02
ACA Neo Geo: Garou - Mark of the Wolves - ACA Neo Geo: Garou - Mark of the Wolves
Duplicate Kingdom Hearts χ Back Cover - Duplicate Kingdom Hearts χ Back Cover
Kuukiyomi: Consider It! - Kuukiyomi: Consider It!
AI Dungeon 2 - AI Dungeon 2
ACA Neo Geo: Metal Slug X - ACA Neo Geo: Metal Slug X
Gravitas - Gravitas
Gladius - Gladius
Cell of Empireo - Cell of Empireo
Linelith - Linelith
Novena - Novena
Monster Rancher 1 & 2 DX - Monster Rancher 1 & 2 DX
Cat Bird - Cat Bird
Top Gunner - Top Gunner
Artificial Academy 2 - Artificial Academy 2
Nurtopu: Fetö ile Mücadele - Nurtopu: Fetö ile Mücadele
Nitrome Must Die - Nitrome Must Die
Super Crush KO - Super Crush KO
Pet Society - Pet Society
Distorted Travesty 3: Saved Game - Distorted Travesty 3: Saved Game
Command & Conquer: Tiberian Sun - Firestorm - Command & Conquer: Tiberian Sun - Firestorm
Mercs - Mercs
ACA Neo Geo: Puzzle Bobble - ACA Neo Geo: Puzzle Bobble
The Last Promise - The Last Promise
Don't Look Back - Don't Look Back
Wacca - Wacca
Arrest of a stone Buddha - Arrest of a stone Buddha
Life Tastes Like Cardboard - Life Tastes Like Cardboard
Kinect Sports - Kinect Sports
Draw Something - Draw Something
Baldur's Gate: Siege of Dragonspear - Baldur's Gate: Siege of Dragonspear
Voxelgram - Voxelgram
Spaceteam - Spaceteam
Defense of the Ancients - Defense of the Ancients
Dandy Dungeon: Legend of Brave Yamada - Dandy Dungeon: Legend of Brave Yamada
Producer (2021) - Producer (2021)
Swan Song - Swan Song
QuizUp - QuizUp
Free Realms - Free Realms
Fallow - Fallow
It Steals - It Steals
3D Fantasy Zone II W - 3D Fantasy Zone II W
Fate/Grand Order - Fate/Grand Order
Pan-Pan - Pan-Pan
Good Sudoku - Good Sudoku
Mysteries Under Lake Ophelia - Mysteries Under Lake Ophelia
IA/VT Colorful - IA/VT Colorful
Super Mario Bros. / Duck Hunt / World Class Track Meet - Super Mario Bros. / Duck Hunt / World Class Track Meet
NHL 12 - NHL 12
Miitomo - Miitomo
Narcissu Side 2nd - Narcissu Side 2nd
No-one has to Die - No-one has to Die
Sewer Rave - Sewer Rave
Shantae: Half-Genie Hero - Pirate Queen's Quest - Shantae: Half-Genie Hero - Pirate Queen's Quest
Sex 2 - Sex 2
Ef: A Fairy Tale of the Two - Ef: A Fairy Tale of the Two
The Ancient Land of Ys - The Ancient Land of Ys
Voice of the Killer - Voice of the Killer
Platform Racing 2 - Platform Racing 2
MU Online - MU Online
Galatea - Galatea
Fate/unlimited codes Portable - Fate/unlimited codes Portable
Pick Pack Pup - Pick Pack Pup
Yume Koujou: Doki-doki Panic - Yume Koujou: Doki-doki Panic
Platformer Toolkit - Platformer Toolkit
That Level Again - That Level Again
Poppy Playtime: Chapter 2 - Fly in a Web - Poppy Playtime: Chapter 2 - Fly in a Web
Venom/Spider-Man: Separation Anxiety - Venom/Spider-Man: Separation Anxiety
Gingiva - Gingiva
Hexologic - Hexologic
Up - Up
Corruption of Champions - Corruption of Champions
Hidden my game by mom - Hidden my game by mom
Aether - Aether
46 Okunen Monogatari: The Shinka Ron - 46 Okunen Monogatari: The Shinka Ron
A Rose in the Twilight - A Rose in the Twilight
The one who pulls out the sword will be crowned king - The one who pulls out the sword will be crowned king
The Legend of Heroes: Ao no Kiseki Kai - The Legend of Heroes: Ao no Kiseki Kai
Leap Day - Leap Day
Post Scriptum - Post Scriptum
Destiny: The Dark Below - Destiny: The Dark Below
Dragon City - Dragon City
Understand - Understand
Jubeat - Jubeat
With Those We Love Alive - With Those We Love Alive
Molek-Syntez - Molek-Syntez
HDoom - HDoom
Solaris - Solaris
Mundial Ronaldinho Soccer 64 - Mundial Ronaldinho Soccer 64
Love 3 - Love 3
Strange Telephone - Strange Telephone
Death Coming - Death Coming
The Last Clockwinder - The Last Clockwinder
I Made a Game with Zombies in It! - I Made a Game with Zombies in It!
Buzz! Junior: Robo Jam - Buzz! Junior: Robo Jam
Meccha! Taiko no Tatsujin DS: 7-tsu no Shima no Daibouken - Meccha! Taiko no Tatsujin DS: 7-tsu no Shima no Daibouken
The Portopia Serial Murder Case - The Portopia Serial Murder Case
Asteroids Deluxe - Asteroids Deluxe
WolfQuest - WolfQuest
Bubble Symphony - Bubble Symphony
Deep Space Waifu: Nekomimi - Deep Space Waifu: Nekomimi
MechQuest - MechQuest
Tanuki Sunset - Tanuki Sunset
World of Warcraft: Warlords of Draenor - World of Warcraft: Warlords of Draenor
Capybara Spa - Capybara Spa
Fantastic Danmaku Festival Part II - Fantastic Danmaku Festival Part II
Tormentor X Punisher - Tormentor X Punisher
A Light in the Dark - A Light in the Dark
Magic Touch: Wizard for Hire - Magic Touch: Wizard for Hire
My Candy Love - My Candy Love
Monolith: Relics of the Past - Monolith: Relics of the Past
Trivia Crack - Trivia Crack
Mr Love: Queen's Choice - Mr Love: Queen's Choice
Mouth Sweet - Mouth Sweet
Cat Planet - Cat Planet
Archero - Archero
Missing Children - Missing Children
MechaNika - MechaNika
Flesh of the Killer - Flesh of the Killer
Microsoft Flight Simulator 2004: A Century of Flight - Microsoft Flight Simulator 2004: A Century of Flight
Fantasy Maiden's Odd Hideout - Fantasy Maiden's Odd Hideout
Exit - Exit
Gunple: Gunman's Proof - Gunple: Gunman's Proof
True Love - True Love
Worldle - Worldle
ACA Neo Geo: Metal Slug 2 - ACA Neo Geo: Metal Slug 2
Mecha Ritz: Steel Rondo - Mecha Ritz: Steel Rondo
Heart&Slash - Heart&Slash
Before the Echo - Before the Echo
ArcheAge - ArcheAge
Ears of the Killer - Ears of the Killer
Shinsekai: Into the Depths - Shinsekai: Into the Depths
Duplicate Super Mario Advance: Super Mario Bros. 2 - Duplicate Super Mario Advance: Super Mario Bros. 2
Chop Suey - Chop Suey
The Forest of Drizzling Rain - The Forest of Drizzling Rain
Command & Conquer: Red Alert - The Aftermath - Command & Conquer: Red Alert - The Aftermath
Paragon - Paragon
Fleshchild - Fleshchild
Surgeon Simulator: Experience Reality - Surgeon Simulator: Experience Reality
Retro/Grade - Retro/Grade
Welcome Park - Welcome Park
Burger Shop - Burger Shop
Pizza Game - Pizza Game
ReDungeon - ReDungeon
Grapple Force Rena - Grapple Force Rena
Dorei to no Seikatsu -Teaching Feeling- - Dorei to no Seikatsu -Teaching Feeling-
Queers in Love at the End of the World - Queers in Love at the End of the World
Dueling Network - Dueling Network
AC/DC Live: Rock Band - Track Pack - AC/DC Live: Rock Band - Track Pack
How We Know We're Alive - How We Know We're Alive
Monmusu Quest! Shuushou ~Makereba Youjo ni Okasareru~ - Monmusu Quest! Shuushou ~Makereba Youjo ni Okasareru~
Robert Ludlum's: The Bourne Conspiracy - Robert Ludlum's: The Bourne Conspiracy
The Entertainment - The Entertainment
True Skate - True Skate
You Left Me - You Left Me
Touhou Blooming Chaos 2 - Touhou Blooming Chaos 2
Solar Striker - Solar Striker
Persona 3: The Answer - Persona 3: The Answer
Ghost Giant - Ghost Giant
Slasher's Keep - Slasher's Keep
SimSafari - SimSafari
Sengoku Basara 2 - Sengoku Basara 2
Amnesia - Amnesia
Hoshizora no Memoria -Wish upon a Shooting Star- - Hoshizora no Memoria -Wish upon a Shooting Star-
N3: Ninety-Nine Nights - N3: Ninety-Nine Nights
Toonix World - Toonix World
Ganpuru: Gunman's Proof - Ganpuru: Gunman's Proof
Silicon Dreams - Silicon Dreams
Audica - Audica
Utawarerumono Zan - Utawarerumono Zan
Irmão Grande & Brasileiro - Irmão Grande & Brasileiro
Big Action Mega Fight! - Big Action Mega Fight!
ACA Neo Geo: Neo Turf Master - ACA Neo Geo: Neo Turf Master
Liar Liar 2 - Liar Liar 2
Deep Space Waifu: World - Deep Space Waifu: World
Nancy Drew: Secrets Can Kill - Nancy Drew: Secrets Can Kill
Touhou Makuka Sai: Fantastic Danmaku Festival Part II - Touhou Makuka Sai: Fantastic Danmaku Festival Part II
Passage - Passage
Ronaldinho Campeonato Brasileiro 98 - Ronaldinho Campeonato Brasileiro 98
Unblock Me - Unblock Me
DX-Ball 2 - DX-Ball 2
OnlyCans: Thirst Date - OnlyCans: Thirst Date
Dungeon Zer0 - Dungeon Zer0
Doomsday Dreamgirl - Doomsday Dreamgirl
Uuultra C - Uuultra C
Antimatter Dimensions - Antimatter Dimensions
A New Home - A New Home
TranscendPang - TranscendPang
Wurroom - Wurroom
Knight's Try - Knight's Try
The Sims 3: High-End Loft Stuff - The Sims 3: High-End Loft Stuff
ACA Neo Geo: The King of Fighters 2002 - ACA Neo Geo: The King of Fighters 2002
duplicate Last Blade 2 - duplicate Last Blade 2
Burger & Frights - Burger & Frights
Enigma: - Enigma:
No Thing - No Thing
Tet - Tet
Ball - Ball
Walk - Walk
Stair Dismount - Stair Dismount
No, Thank You!!! - No, Thank You!!!
The Flower Collectors - The Flower Collectors
Flappy Golf - Flappy Golf
Galaxy Fräulein Yuna - Galaxy Fräulein Yuna
Windlands - Windlands
HyperRogue - HyperRogue
duplicate Backbone: Prologue - duplicate Backbone: Prologue
Score! Hero - Score! Hero
Twin Breaker: A Sacred Symbols Adventure - Twin Breaker: A Sacred Symbols Adventure
Royal Alchemist - Royal Alchemist
Nigel Mansell's World Championship - Nigel Mansell's World Championship
Scar of the Doll - Scar of the Doll
Happy's Humble Burger Barn - Happy's Humble Burger Barn
Lapse: A Forgotten Future - Lapse: A Forgotten Future
From Next Door - From Next Door
Kokuga - Kokuga
The Blockheads - The Blockheads
Peeb Adventures - Peeb Adventures
Micro Platformer - Micro Platformer
Witch & Hero - Witch & Hero
Shiritsu Justice Gakuen: Nekketsu Seishun Nikki 2 - Shiritsu Justice Gakuen: Nekketsu Seishun Nikki 2
The Barnacle Goose Experiment - The Barnacle Goose Experiment
Duck Life - Duck Life
This is the Only Level 3 - This is the Only Level 3
MapFriend - MapFriend
Disney's The Lion King 1 1/2 - Disney's The Lion King 1 1/2
Destiny: The Collection - Destiny: The Collection
Un Pueblo de Nada - Un Pueblo de Nada
Zodiacats - Zodiacats
Gunlocked - Gunlocked
Catlateral Damage: Remeowstered - Catlateral Damage: Remeowstered
Summer Games - Summer Games
Palette - Palette
Xmas Shooting: Scramble!! - Xmas Shooting: Scramble!!
Bonk.io - Bonk.io
Dragon Saga - Dragon Saga
ClayFighter 63 1/3 - ClayFighter 63 1/3
Broken Picturephone - Broken Picturephone
Rodent's Revenge - Rodent's Revenge
I Love Hue Too - I Love Hue Too
Swarmlake - Swarmlake
GTTOD: Get to the Orange Door - GTTOD: Get to the Orange Door
Lockheart Indigo - Lockheart Indigo
Nova-111 - Nova-111
The Shadows That Run Alongside Our Car - The Shadows That Run Alongside Our Car
Highway Blossoms: Next Exit - Highway Blossoms: Next Exit
Golf on Mars - Golf on Mars
Lunia - Lunia
MenheRafflesia - MenheRafflesia
Pudding Monsters - Pudding Monsters
Super One More Jump - Super One More Jump
Cinco Paus - Cinco Paus
Expand - Expand
Fallstreak: Requiem For My Homeland - Fallstreak: Requiem For My Homeland
The Legend of Heroes: Ao no Kiseki Evolution - The Legend of Heroes: Ao no Kiseki Evolution
Outlive - Outlive
The Legend of Heroes: Zero no Kiseki Evolution - The Legend of Heroes: Zero no Kiseki Evolution
Kiwi 64 - Kiwi 64
Gahkthun of the Golden Lightning - Gahkthun of the Golden Lightning
The Radio Station - The Radio Station
Outlaw - Outlaw
Bike Race - Bike Race
Omaze - Omaze
MazM: Jekyll and Hyde - MazM: Jekyll and Hyde
.hack//Link - .hack//Link
Gun Club VR - Gun Club VR
Hungry Cat Picross - Hungry Cat Picross
Dragon City Mobile - Dragon City Mobile
Climbey - Climbey
Chrono Clock - Chrono Clock
No Time to Relax - No Time to Relax
Yupitergrad - Yupitergrad
Record of Agarest War - Record of Agarest War
Dominique Pamplemousse in "It's all Over Once The Fat Lady Sings!" - Dominique Pamplemousse in "It's all Over Once The Fat Lady Sings!"
Roly-Polys no Nanakorobi Yaoki - Roly-Polys no Nanakorobi Yaoki
Alphabet Park Adventure - Alphabet Park Adventure
How to Say Goodbye - How to Say Goodbye
Miscrits: World of Creatures - Miscrits: World of Creatures
Discolored - Discolored
Hope Left Me - Hope Left Me
Mysterious Forum and 7 Rumors - Mysterious Forum and 7 Rumors
Ranma 1/2: Hard Battle - Ranma 1/2: Hard Battle
Bowmasters - Bowmasters
Narcissu 10th Anniversary Anthology Project - Narcissu 10th Anniversary Anthology Project
Fractured Minds - Fractured Minds
Invizimals: The Lost Kingdom - Invizimals: The Lost Kingdom
Record of Agarest War Zero - Record of Agarest War Zero
Dynamix - Dynamix
Whale Trail - Whale Trail
Makoto Mobius - Makoto Mobius
Total War Saga: Thrones of Britannia - Total War Saga: Thrones of Britannia
Yu-Gi-Oh! 5D's Duel Transer - Yu-Gi-Oh! 5D's Duel Transer
The Sims 3: 70s, 80s, & 90s Stuff - The Sims 3: 70s, 80s, & 90s Stuff
KulaQuest - KulaQuest
Techno Kitten Adventure - Techno Kitten Adventure
There Swings a Skull - There Swings a Skull
Rebuild - Rebuild
Shotgun Witch - Shotgun Witch
The Temple of No - The Temple of No
SinoAlice - SinoAlice
Neotrogla - Neotrogla
You and I and the Long, Long Drive - You and I and the Long, Long Drive
Lemnis Gate - Lemnis Gate
Rose of Winter - Rose of Winter
Liar Liar - Liar Liar
TankTrouble - TankTrouble
Dogurai - Dogurai
Lips - Lips
Serious Sam 3: Jewel of the Nile - Serious Sam 3: Jewel of the Nile
Time Clickers - Time Clickers
Music: Music Creation for the PlayStation - Music: Music Creation for the PlayStation
Surgeon Simulator VR: Meet the Medic - Surgeon Simulator VR: Meet the Medic
Gretel and Hansel - Gretel and Hansel
Crash & Spyro Superpack: Crash Bandicoot Purple/Spyro Orange - Crash & Spyro Superpack: Crash Bandicoot Purple/Spyro Orange
Online Soccer Manager (OSM) - Online Soccer Manager (OSM)
That Level Again 3 - That Level Again 3
Spice and Wolf VR - Spice and Wolf VR
Pagan: Technopolis - Pagan: Technopolis
Help Me Remember, Satori-sama! - Help Me Remember, Satori-sama!
Dragonfire - Dragonfire
First Steps - First Steps
Raging Blasters - Raging Blasters
SpellTower - SpellTower
ChocuPixel - ChocuPixel
Interior Worlds - Interior Worlds
The Endless Forest - The Endless Forest
Membrane - Membrane
Out of the Park Baseball 19 - Out of the Park Baseball 19
My Friend is a Raven - My Friend is a Raven
Deadliest Warrior: Legends - Deadliest Warrior: Legends
Critical Ops - Critical Ops
Detective Nakamura: The Azure Case - Detective Nakamura: The Azure Case
War of the Human Tanks - War of the Human Tanks
Yume Nisshi - Yume Nisshi
Age of Conan: Hyborian Adventures - Age of Conan: Hyborian Adventures
The Walking Zombie 2 - The Walking Zombie 2
The King of Fighters 2000/2001 - The King of Fighters 2000/2001
Happy Harvest - Happy Harvest
Persona 3: The Journey - Persona 3: The Journey
Hitchhiker - Hitchhiker
Spooky Station - Spooky Station
crossbeats REV. Sunrise - crossbeats REV. Sunrise
ACA Neo Geo: Twinkle Star Sprites - ACA Neo Geo: Twinkle Star Sprites
DraKoI - DraKoI
Puzzling Places - Puzzling Places
Noise1 - Noise1
Mardek RPG: Chapter 1 - Mardek RPG: Chapter 1
Under Leaves - Under Leaves
The Manga Works - The Manga Works
Nanopesos - Nanopesos
Eldarya - Eldarya
Pokédex 3D - Pokédex 3D
duplicate Akumajou Dracula X: Chi no Rondo - duplicate Akumajou Dracula X: Chi no Rondo
Grand Fantasia - Grand Fantasia
Beat Stomper - Beat Stomper
Libretta - Libretta
Wolfgirls in Love - Wolfgirls in Love
The Catacombs of Solaris - The Catacombs of Solaris
Space/Mech/Pilot - Space/Mech/Pilot
Please Knock on My Door - Please Knock on My Door
.Hack//G.U. Vol. 1: Rebirth HD - .Hack//G.U. Vol. 1: Rebirth HD
Next Door - Next Door
World's Dawn - World's Dawn
Aerial_Knight's Never Yield - Aerial_Knight's Never Yield
Arena of Valor - Arena of Valor
5 Minutes to Kill Yourself - 5 Minutes to Kill Yourself
Asteroid - Asteroid
Spiral Clicker - Spiral Clicker
NITE Team 4 - NITE Team 4
P.E. Noire - P.E. Noire
FeralHeart - FeralHeart
Pizza Tycoon - Pizza Tycoon
Monster of the Deep: Final Fantasy XV - Monster of the Deep: Final Fantasy XV
Rolando - Rolando
Eternal Home Floristry - Eternal Home Floristry
Hentai Nazi - Hentai Nazi
Trespasser - Trespasser
Sly Spy - Sly Spy
Star Wars: Tales from the Galaxy's Edge - Star Wars: Tales from the Galaxy's Edge
Barbie Beauty Boutique - Barbie Beauty Boutique
Ingress - Ingress
World End Economica - World End Economica
Dark Reign: The Future of War - Dark Reign: The Future of War
Flappy Golf 2 - Flappy Golf 2
Griptape Backbone - Griptape Backbone
Stay - Stay
Our Life: Now & Forever - Our Life: Now & Forever
Hidden Paws - Hidden Paws
Rust Bucket - Rust Bucket
World End Economica: Episode.02 - World End Economica: Episode.02
Miscrits: Volcano Island - Miscrits: Volcano Island
Underhand - Underhand
Choices: Stories You Play - Choices: Stories You Play
Granny Simulator - Granny Simulator
Plaque Attack - Plaque Attack
Mini Healer - Mini Healer
Duck Season PC - Duck Season PC
Fish Out of Water! - Fish Out of Water!
Wild Animal Racing - Wild Animal Racing
Splatter - Splatter
Drowning, Drowning - Drowning, Drowning
Robot Wants It All - Robot Wants It All
Where Cards Fall - Where Cards Fall
N.O.V.A. - N.O.V.A.
Pop Town - Pop Town
Depict1 - Depict1
Gohome - Gohome
Pokonyan! Henpokorin Adventure - Pokonyan! Henpokorin Adventure
Treasure Cove! - Treasure Cove!
99 Bricks Wizard Academy - 99 Bricks Wizard Academy
Q.u.q. - Q.u.q.
Atma - Atma
Killer7 Remaster - Killer7 Remaster
Life After Magic - Life After Magic
World to the West - World to the West
Enemy Mind - Enemy Mind
ACA Neo Geo: The King of Fighters '99 - ACA Neo Geo: The King of Fighters '99
You Died but a Necromancer Revived You - You Died but a Necromancer Revived You
Zugzwang - Zugzwang
Voodoo Garden - Voodoo Garden
Head Soccer - Head Soccer
Ballads at Midnight - Ballads at Midnight
Racket: Nx - Racket: Nx
PC Fútbol 2001 - PC Fútbol 2001
The Machine - The Machine
Ketzal's Corridors - Ketzal's Corridors
Sono Hanabira ni Kuchizuke o: Itoshisa no Photograph - Sono Hanabira ni Kuchizuke o: Itoshisa no Photograph
Garden of the Sea - Garden of the Sea
Xevious 3D/G - Xevious 3D/G
Inversus - Inversus
ACA Neo Geo: Waku Waku 7 - ACA Neo Geo: Waku Waku 7
The Most Desperate Angel - The Most Desperate Angel
Yuki Onna - Yuki Onna
One Hour One Life - One Hour One Life
Security Booth: Director's Cut - Security Booth: Director's Cut
Exponential Idle - Exponential Idle
Cricket 19 - Cricket 19
Last Command - Last Command
Mr. Massagy - Mr. Massagy
Major Havoc - Major Havoc
Monster Hunter Online - Monster Hunter Online
Demonheart - Demonheart
Marvel Future Revolution - Marvel Future Revolution
Gothic Murder: Adventure That Changes Destiny - Gothic Murder: Adventure That Changes Destiny
\\\//\\/\\\/// - \\\//\\/\\\///
Girlish Grimoire Littlewitch Romanesque - Girlish Grimoire Littlewitch Romanesque
Obakeidoro! - Obakeidoro!
Zynga Poker – Texas Holdem - Zynga Poker – Texas Holdem
Gambling Apocalypse Kaiji - Gambling Apocalypse Kaiji
Here and There Along the Echo - Here and There Along the Echo
Sumatra: Fate of Yandi - Sumatra: Fate of Yandi
Castle of the Winds - Castle of the Winds
Planet Harriers - Planet Harriers
The Shopping List - The Shopping List
Swords and Sandals 2 Redux: Maximus Edition - Swords and Sandals 2 Redux: Maximus Edition
Lily's Night Off - Lily's Night Off
Swords & Soldiers II - Swords & Soldiers II
Grand Cross Renovation - Grand Cross Renovation
Mr. Saitou - Mr. Saitou
Marginalia - Marginalia
Last Day on Earth: Survival - Last Day on Earth: Survival
Eat Beat: Dead Spike-san - Eat Beat: Dead Spike-san
Obama Boss Fight - Obama Boss Fight
Dawngate - Dawngate
Lapse 2: Before Zero - Lapse 2: Before Zero
Paletta - Paletta
SimPark - SimPark
Ben and Ed: Blood Party - Ben and Ed: Blood Party
Slender-Man - Slender-Man
Travian: Legends - Travian: Legends
Chess Evolved Online - Chess Evolved Online
Waven - Waven
Guitar Girl - Guitar Girl
Helix - Helix
Segare Ijiri - Segare Ijiri
Pub Encounter - Pub Encounter
B-Cubed - B-Cubed
The Maid of Fairewell Heights - The Maid of Fairewell Heights
Antiyoy - Antiyoy
Jettomero: Hero of the Universe - Jettomero: Hero of the Universe
Dictators:No Peace Countryballs - Dictators:No Peace Countryballs
Copper Odyssey - Copper Odyssey
Red Embrace - Red Embrace
Dan-Ku-Ga - Dan-Ku-Ga
Windlands 2 - Windlands 2
Dominique Pamplemousse & Dominique Pamplemousse in "Combinatorial Explosion" - Dominique Pamplemousse & Dominique Pamplemousse in "Combinatorial Explosion"
Pyramida - Pyramida
Kissed by the Baddest Bidder - Kissed by the Baddest Bidder
Tangled: The Video Game - Tangled: The Video Game
School Girl/Zombie Hunter - School Girl/Zombie Hunter
0h h1 - 0h h1
Hasbro's Battleship - Hasbro's Battleship
Crazy Penguin Catapult - Crazy Penguin Catapult
World Conqueror 3 - World Conqueror 3
The Last Stand: Dead Zone - The Last Stand: Dead Zone
Recoil - Recoil
Bike Baron - Bike Baron
I Love You! - I Love You!
Evil Factory - Evil Factory
Bravery Network Online - Bravery Network Online
Creme de la Creme - Creme de la Creme
I Love Katamari - I Love Katamari
Academia: School Simulator - Academia: School Simulator
The Grim Reaper Who Reaped My Heart - The Grim Reaper Who Reaped My Heart
Ninja Saga - Ninja Saga
America's Army - America's Army
Gunhouse - Gunhouse
Ef: The First Tale. - Ef: The First Tale.
Battletoads / Double Dragon: The Ultimate Team - Battletoads / Double Dragon: The Ultimate Team
Adventure Bar Story - Adventure Bar Story
Record of Agarest War 2 - Record of Agarest War 2
Backyard Hockey - Backyard Hockey
Golf Battle - Golf Battle
Cooking Simulator VR - Cooking Simulator VR
Indecision. - Indecision.
Toripon - Toripon
Super Star Path - Super Star Path
Tasokare Hotel - Tasokare Hotel
Shadowmatic - Shadowmatic
10mg: You are such a Soft and Round Kitten. - 10mg: You are such a Soft and Round Kitten.
Domino's App feat. Hatsune Miku - Domino's App feat. Hatsune Miku
Just One Boss - Just One Boss
Andromeda Six - Andromeda Six
Socrates Jones: Pro Philosopher - Socrates Jones: Pro Philosopher
Chessformer - Chessformer
The Elder Scrolls Online: Dragonhold - The Elder Scrolls Online: Dragonhold
Kitty Powers' Love Life - Kitty Powers' Love Life
Loek - Loek
Intralism - Intralism
Poker Smash - Poker Smash
Blendoku 2 - Blendoku 2
Hand Simulator: Survival - Hand Simulator: Survival
.Hack//Frägment - .Hack//Frägment
Fighting Mania: Fist of the North Star - Fighting Mania: Fist of the North Star
KKnD2: Krossfire - KKnD2: Krossfire
We Met in May - We Met in May
Asphyxia - Asphyxia
Skate City - Skate City
Twin Saga - Twin Saga
Crash Drive 2 - Crash Drive 2
Tax Heaven 3000 - Tax Heaven 3000
The Fish Market - The Fish Market
Heroes of Might and Magic IV: Winds of War - Heroes of Might and Magic IV: Winds of War
Lady Bug - Lady Bug
Crazy Planets - Crazy Planets
Population: Tire - Population: Tire
Father and Son - Father and Son
Octordle - Octordle
duplicate RISK: Global Domination - duplicate RISK: Global Domination
Crimson Dragon - Crimson Dragon
Has-Been Heroes - Has-Been Heroes
Little Party - Little Party
He Beat Her. - He Beat Her.
Qbasic Gorillas - Qbasic Gorillas
Warlords III: Darklords Rising - Warlords III: Darklords Rising
I Am Jesus Christ - I Am Jesus Christ
Duplicate Silent Hill 2: Director's Cut - Duplicate Silent Hill 2: Director's Cut
Midnight Protocol - Midnight Protocol
Taisho x Alice: Heads & Tails! - Taisho x Alice: Heads & Tails!
The 9th Annual Vanilla Level Design Contest: Collaboration Hack - The 9th Annual Vanilla Level Design Contest: Collaboration Hack
Summer Paws - Summer Paws
TransBot - TransBot
Filthbreed - Filthbreed
The Block - The Block
Spellcorked! - Spellcorked!
Super Impossible Road - Super Impossible Road
Birdsong - Birdsong
Ghosts of Miami - Ghosts of Miami
GaiaSeed: Project Seed Trap - GaiaSeed: Project Seed Trap
SM64 Sapphire - SM64 Sapphire
TerraGenesis - Space Settlers - TerraGenesis - Space Settlers
Timing Hero - Timing Hero
Table Tennis - Table Tennis
Bomb It - Bomb It
Super Monsters Ate My Condo - Super Monsters Ate My Condo
Goalkeeper Training VR - Goalkeeper Training VR
Find Yourself - Find Yourself
Her New Memory - Her New Memory
Ashes Cricket - Ashes Cricket
Evo\Wave - Evo\Wave
Tokyo Crash Mobs - Tokyo Crash Mobs
Endeavor - Endeavor
Gilbert Goodmate and the Mushroom of Phungoria - Gilbert Goodmate and the Mushroom of Phungoria
EarthWorms - EarthWorms
StrongBadZone - StrongBadZone
Pendragon - Pendragon
Extreme Warfare Revenge - Extreme Warfare Revenge
The Signal State - The Signal State
Pocket League Story - Pocket League Story
Feed the Head - Feed the Head
Idle Apocalypse - Idle Apocalypse
Kana: Little Sister - Kana: Little Sister
Super Mario World Randomizer - Super Mario World Randomizer
Metal Gear Solid Touch - Metal Gear Solid Touch
ACA Neo Geo: Samurai Shodown - ACA Neo Geo: Samurai Shodown
O2Jam - O2Jam
Where the Goats Are - Where the Goats Are
Draw Something Classic - Draw Something Classic
MinuteQues‪t‬ - MinuteQues‪t‬
Who Has the Biggest Brain? - Who Has the Biggest Brain?
Library - Library
Alter Ego Complex - Alter Ego Complex
The Divine Speaker - The Divine Speaker
Scars of Summer - Scars of Summer
Ef: The Latter Tale. - Ef: The Latter Tale.
Infernium - Infernium
Raimais - Raimais
Horse Master - Horse Master
Gary Grigsby's War in the East - Gary Grigsby's War in the East
Times Infinity - Times Infinity
Wipeout In the Zone - Wipeout In the Zone
Anna - Anna
Jumper - Jumper
Ordia - Ordia
SuperEpic: The Entertainment War - SuperEpic: The Entertainment War
Neo Aquarium: The King of Crustaceans - Neo Aquarium: The King of Crustaceans
You Must be 18 or Older to Enter - You Must be 18 or Older to Enter
Roommates - Roommates
NecroMerger - NecroMerger
Superhotline Miami Deluxe - Superhotline Miami Deluxe
SCP-087 - SCP-087
Sedecordle - Sedecordle
The Alchemist Code - The Alchemist Code
Cat Game! - Cat Game!
Dear My Cat - Dear My Cat
Mr Crab - Mr Crab
Evil Apples: Dirty as ____. - Evil Apples: Dirty as ____.
That Level Again 4 - That Level Again 4
Cellular Harvest - Cellular Harvest
Scooby-Doo and The Creepy Castle - Scooby-Doo and The Creepy Castle
Without Within - Without Within
Anteater - Anteater
Will Die Alone - Will Die Alone
FixFox - FixFox
Sensible World of Soccer '96/'97 - Sensible World of Soccer '96/'97
Hikeback - Hikeback
KKnD - KKnD
Fault: Stp - Lightkravte - Fault: Stp - Lightkravte
Katekyo Hitman Reborn! DS Flame Rumble XX - Kessen! Real 6 Chouka - Katekyo Hitman Reborn! DS Flame Rumble XX - Kessen! Real 6 Chouka
Ganbare! Daiku no Gensan - Ganbare! Daiku no Gensan
I See You - I See You
Blaster - Blaster
House of Detention - House of Detention
Super Mario Bros. / Tetris / Nintendo World Cup - Super Mario Bros. / Tetris / Nintendo World Cup
A Gay Love Story About Gay Love - A Gay Love Story About Gay Love
Uneven Dream - Uneven Dream
RymdResa - RymdResa
Dab on Darkness! - Dab on Darkness!
Ghost Case - Ghost Case
Crystal Caves HD - Crystal Caves HD
Narcissu Sumire - Narcissu Sumire
Homescapes - Homescapes
Gimme Money! Neverquaker - Gimme Money! Neverquaker
The Adventure of Hourai High School - The Adventure of Hourai High School
Karakara - Karakara
Entropoly - Entropoly
Pepper's Puzzles - Pepper's Puzzles
Johnny's Payday Panic - Johnny's Payday Panic
Walking Simulator A Month Club (Complete Edition) - Walking Simulator A Month Club (Complete Edition)
ACA Neo Geo: The King of Fighters '94 - ACA Neo Geo: The King of Fighters '94
Il Filo Conduttore - Il Filo Conduttore
Scarlett Mysteries: Cursed Child - Scarlett Mysteries: Cursed Child
Small Soldiers: Squad Commander - Small Soldiers: Squad Commander
Marble Skies - Marble Skies
Sheriff - Sheriff
Shaiya - Shaiya
Quake: The Offering - Quake: The Offering
Ultrawings - Ultrawings
Epiphany City - Epiphany City
Spl-t - Spl-t
ZigZag - ZigZag
SoniPro - SoniPro
Alphabet - Alphabet
Knights College - Knights College
Brain Dots - Brain Dots
Leftovers - Leftovers
Florensia - Florensia
The Last Days of Our Castle - The Last Days of Our Castle
D/Generation - D/Generation
EyeToy: AntiGrav - EyeToy: AntiGrav
Nostalgic Train - Nostalgic Train
Just King - Just King
Miserere - Miserere
The Perfect Tower II - The Perfect Tower II
In the Rural Village of Nagoro - In the Rural Village of Nagoro
Beastie Bay - Beastie Bay
Lies Beneath - Lies Beneath
Winter Polaris - Winter Polaris
Dr. Lunatic Supreme with Cheese - Dr. Lunatic Supreme with Cheese
Fun Run 3: Arena Running Game - Fun Run 3: Arena Running Game
The Banner Saga: Factions - The Banner Saga: Factions
Cladun Returns: This is Sengoku! - Cladun Returns: This is Sengoku!
Destroy the Porn - Destroy the Porn
Peace, Death! 2 - Peace, Death! 2
Postknight 2 - Postknight 2
Jogo Satanista para Praticar o Mal - Jogo Satanista para Praticar o Mal
The Endless Express - The Endless Express
Keen - Keen
The Tartarus Key - The Tartarus Key
Mable and the Wood - Mable and the Wood
Furcadia - Furcadia
Alpine Racer 2 - Alpine Racer 2
Liberal Crime Squad - Liberal Crime Squad
Magic Vigilante - Magic Vigilante
The Ensign - The Ensign
Maptroid - Maptroid
Gakuen Club - Gakuen Club
Treasure Adventure World - Treasure Adventure World
Meeblings - Meeblings
Deleveled - Deleveled
Juurru - Juurru
Doggy Dinner Time - Doggy Dinner Time
Ending - Ending
Rupupu Cube: Lup Salad - Rupupu Cube: Lup Salad
Need to Know - Need to Know
Touhoumon Purple - Touhoumon Purple
Postbird in Provence - Postbird in Provence
Arthur's Camping Adventure - Arthur's Camping Adventure
Bid For Power - Bid For Power
Nemesis 2 - Nemesis 2
That Which Gave Chase - That Which Gave Chase
Demonpact: Clarice - Demonpact: Clarice
Anne Frank House VR - Anne Frank House VR
Radical Rabbit Stew - Radical Rabbit Stew
Lost Pig (And Place Under Ground) - Lost Pig (And Place Under Ground)
Nyakori's Rabbit Doll - Nyakori's Rabbit Doll
Hades' Star - Hades' Star
Radiohammer - Radiohammer
Rising World - Rising World
Aquales - Aquales
Harmony: The Fall of Reverie - Harmony: The Fall of Reverie
Big Tiddy Goth GF Simulator - Big Tiddy Goth GF Simulator
PopSauce - PopSauce
Exo One: Prologue - Exo One: Prologue
United Heist - United Heist
Feedvid Live - Feedvid Live
Trash Horror Collection - Trash Horror Collection
Murder on the Marine Express - Murder on the Marine Express
Inked - Inked
Tone Sphere - Tone Sphere
Cosmic Break - Cosmic Break
Hotel Giant - Hotel Giant
The Yukon Trail - The Yukon Trail
