Os fantásticos livros voadores de Modesto Máximo - Os fantásticos livros voadores de Modesto Máximo
Box Percy Jackson E Os Olimpianos (5 Volumes) - Box Percy Jackson E Os Olimpianos (5 Volumes)
Como trair o herói de um dragão - Como trair o herói de um dragão
Box Biblioteca Hogwarts - Box Biblioteca Hogwarts
Meu amigo Michael - Meu amigo Michael
Antes da Forca - Antes da Forca
Como Roubar A Espada de Um Dragão - Como Roubar A Espada de Um Dragão
Como pegar a joia do dragão - Como pegar a joia do dragão
O Jardim Esquecido - O Jardim Esquecido
Trago seu amor de volta sem pedir nada em troca - Trago seu amor de volta sem pedir nada em troca
A invenção da natureza - A invenção da natureza
Uma Esperança Mais Forte Que o Mar - Uma Esperança Mais Forte Que o Mar
Em busca de Watership Down - Em busca de Watership Down
Em Busca de Watership Down - Em Busca de Watership Down
Boteco dos Deuses - Boteco dos Deuses
Colecionadores de Histórias - Colecionadores de Histórias
Flor da Neve e o Leque Secreto - Flor da Neve e o Leque Secreto
A vida secreta de Marilyn Monroe - A vida secreta de Marilyn Monroe
As Cordas Mágicas - As Cordas Mágicas
Guerra e Spray - Guerra e Spray
Como partir o coração de um dragão - Como partir o coração de um dragão
Frankenstein; O Médico e o Monstro; Drácula - Frankenstein; O Médico e o Monstro; Drácula
Eu, Elton John - Eu, Elton John
Três Semanas Com Meu Irmão - Três Semanas Com Meu Irmão
Encantada por Você - Encantada por Você
A Irmandade Perdida - A Irmandade Perdida
O Duelo dos Reis - O Duelo dos Reis
A Cidade dos Espelhos - A Cidade dos Espelhos
Uma Lição Inesquecível  - Uma Lição Inesquecível 
O Homem da Lua - O Homem da Lua
Os Mercadores da Noite - Os Mercadores da Noite
A Rainha das Trevas - A Rainha das Trevas
Mudbound: Lágrimas Sobre o Mississippi - Mudbound: Lágrimas Sobre o Mississippi
O nome de Deus é Misericórdia - O nome de Deus é Misericórdia
O Nome de Deus É Misericórdia - O Nome de Deus É Misericórdia
Redenção Sombria - Redenção Sombria
Sempre - A Redenção - Sempre - A Redenção
Um cão chamado Jimmy - Um cão chamado Jimmy
O amor que sinto agora - O amor que sinto agora
Espiral da Morte - Espiral da Morte
O Livro De Colorir Do Harry Potter - O Livro De Colorir Do Harry Potter
Queimada Viva - Queimada Viva
Código de um cavaleiro - Código de um cavaleiro
Os Filhos da Tempestade - Os Filhos da Tempestade
O segredo de Frida Kahlo - O segredo de Frida Kahlo
O Segredo de Frida Kahlo - O Segredo de Frida Kahlo
Os Dois Mundos de Isabel - Os Dois Mundos de Isabel
Amos e Masmorras - A Submissão - Amos e Masmorras - A Submissão
Sr. Ardiloso Cortês - Sr. Ardiloso Cortês
Box Crepúsculo - Box Crepúsculo
Box Saga Crepúsculo - Box Saga Crepúsculo
Eric Clapton: a autobiografia - Eric Clapton: a autobiografia
Eric Clapton - Eric Clapton
Amos e Masmorras - O Torneio - Amos e Masmorras - O Torneio
Pequeno Dicionário de Palavras ao Vento - Pequeno Dicionário de Palavras ao Vento
Rebeldes têm asas - Rebeldes têm asas
O que eu sei de verdade - O que eu sei de verdade
Jardins da Lua - Jardins da Lua
Nas tuas mãos - Nas tuas mãos
Os Arquivos da Magia - Os Arquivos da Magia
Morte no Buraco Negro - Morte no Buraco Negro
Cinquenta tons de liberdade: O capítulo final - Cinquenta tons de liberdade: O capítulo final
A Arte de Ser Normal - A Arte de Ser Normal
A Cama na Varanda  - A Cama na Varanda 
À Margem das Sombras - À Margem das Sombras
Caminho das Sombras - Caminho das Sombras
Ahmnat - Ahmnat
Agora Que Sou Mãe - Agora Que Sou Mãe
Hiperespaço - Hiperespaço
Esqueceram de mim - Esqueceram de mim
O Médico da Humanidade e A Cura da Corrupção - O Médico da Humanidade e A Cura da Corrupção
Em Nome dos Pais - Em Nome dos Pais
Amos e Masmorras - A Missão - Amos e Masmorras - A Missão
Jornada pelo Rio Mar - Jornada pelo Rio Mar
Nas Garras da Praga das Sombras - Nas Garras da Praga das Sombras
Comer Para Não Morrer - Comer Para Não Morrer
O Melhor Amigo do Inimigo - O Melhor Amigo do Inimigo
O Cadáver que Ri - O Cadáver que Ri
O pequeno livro de colorir do Príncipe - O pequeno livro de colorir do Príncipe
O Pequeno Príncipe Para Colorir - O Pequeno Príncipe Para Colorir
Café dos Loucos - Café dos Loucos
Esplim de Paris : Pequenos Poemas em Prosa - Esplim de Paris : Pequenos Poemas em Prosa
Star Wars: Os últimos Jedi - Star Wars: Os últimos Jedi
Entre Bardos e Druidas - Entre Bardos e Druidas
Mergulhe na Magia: Os Bastidores de Animais Fantásticos e Onde Habitam - Mergulhe na Magia: Os Bastidores de Animais Fantásticos e Onde Habitam
Simplesmente Tini - Simplesmente Tini
Os Arquivos de Sherlock Holmes - Os Arquivos de Sherlock Holmes
Beije a Garota - Beije a Garota
A Garota Que Você Deixou Para Trás - A Garota Que Você Deixou Para Trás
 À sombra da lua -  À sombra da lua
A Esposa Silenciosa - A Esposa Silenciosa
Box Os Heróis do Olimpo - Box Os Heróis do Olimpo
A Sagração da Primavera - A Sagração da Primavera
O Invisível aos Olhos - O Invisível aos Olhos
Mulheres Alteradas 5 - Mulheres Alteradas 5
As Letras dos Beatles - As Letras dos Beatles
Oceano Perdido - Oceano Perdido
Onze aneis - Onze aneis
1001 Dias Que Abalaram O Mundo - 1001 Dias Que Abalaram O Mundo
1001 Discos Para Ouvir Antes de Morrer - 1001 Discos Para Ouvir Antes de Morrer
1001 Discos Para Ouvir Antes de Morrer  - 1001 Discos Para Ouvir Antes de Morrer 
1001 discos para ouvir antes de morrer - 1001 discos para ouvir antes de morrer
O clube de boxe de Berlim - O clube de boxe de Berlim
Aden Stone contra o Reino das Bruxas  - Aden Stone contra o Reino das Bruxas 
A Lady de Lyon - A Lady de Lyon
Deixei Você Ir - Deixei Você Ir
O Ano da Morte de Ricardo Reis - O Ano da Morte de Ricardo Reis
O Silêncio da Cidade Branca - O Silêncio da Cidade Branca
Quando o sofrimento bater à sua porta - Quando o sofrimento bater à sua porta
Enquanto Bela Dormia - Enquanto Bela Dormia
Sobre Heróis e Tumbas - Sobre Heróis e Tumbas
Café Da Manhã Dos Campeões - Café Da Manhã Dos Campeões
Quem me roubou de mim? - Quem me roubou de mim?
A Identidade Bourne - A Identidade Bourne
Segredos e Mentiras - Segredos e Mentiras
Apenas Uma Garota - Apenas Uma Garota
33 Estratégias de guerra - EDIÇÃO CONCISA - 33 Estratégias de guerra - EDIÇÃO CONCISA
Uma Fortuna Perigosa - Uma Fortuna Perigosa
Conquistando o Inimigo - Conquistando o Inimigo
Diário em Tópicos - Diário em Tópicos
Diário em tópicos - Diário em tópicos
Meninas de Calças - Meninas de Calças
A Vida Que Enterramos - A Vida Que Enterramos
Odd e os Gigantes de Gelo - Odd e os Gigantes de Gelo
A Maldição de Hollow - A Maldição de Hollow
O império é você - O império é você
O Livro Perigoso para Garotos (de bolso) - O Livro Perigoso para Garotos (de bolso)
O Livro Perigoso para Garotos - O Livro Perigoso para Garotos
Histórias de Horror - Histórias de Horror
A Pedra Pagã - A Pedra Pagã
Onde Existe Amor, Deus Aí Está - Onde Existe Amor, Deus Aí Está
As montanhas de Buda - As montanhas de Buda
Meia Guerra - Meia Guerra
Encantada por você - Encantada por você
A Mulher de Pilatos - A Mulher de Pilatos
Mulher-Gato: Ladra de Almas - Mulher-Gato: Ladra de Almas
O Sr. Pip - O Sr. Pip
Cinzas da Meia-Noite - Cinzas da Meia-Noite
Mulheres Alteradas 3 - Mulheres Alteradas 3
O Cortador de Pedras - O Cortador de Pedras
No Badalar da Meia-Noite - No Badalar da Meia-Noite
Corajosa sim, perfeita não - Corajosa sim, perfeita não
1001 Invenções que mudaram O Mundo - 1001 Invenções que mudaram O Mundo
Sociedade com Deus - Sociedade com Deus
Minha Vida Como Um Ramone - Minha Vida Como Um Ramone
Rogue One: Uma História Star Wars - Rogue One: Uma História Star Wars
501 Grandes Escritores - 501 Grandes Escritores
A Noite Escura e Mais Eu - A Noite Escura e Mais Eu
Império das Tormentas - Império das Tormentas
Skagboys - Skagboys
Por Trás do Véu de Ísis - Por Trás do Véu de Ísis
O Menino Que Acreditava Em Milagres - O Menino Que Acreditava Em Milagres
Os Quase Completos - Os Quase Completos
Diário de um zumbi do Minecraft - Diário de um zumbi do Minecraft
Titia Terrível  - Titia Terrível 
Rainha de Katwe - Rainha de Katwe
Profissão Repórter 10 Anos - Profissão Repórter 10 Anos
O Ano do Dilúvio - O Ano do Dilúvio
Traição em Família - Traição em Família
Bebês submarinos - Bebês submarinos
O centésimo em Roma - O centésimo em Roma
A História do Mundo em 100 Objetos - A História do Mundo em 100 Objetos
Em Defesa da Comida - Em Defesa da Comida
O Monge e a Coruja - O Monge e a Coruja
A Arquitetura da Felicidade - A Arquitetura da Felicidade
O Primeiro Homem - O Primeiro Homem
Nate vai para o tudo ou nada - Nate vai para o tudo ou nada
Órfão X - Órfão X
Possuída Pela Noite - Possuída Pela Noite
Antes de dizer adeus - Antes de dizer adeus
Mensagens de Esperança - Mensagens de Esperança
Amores ao sol - Amores ao sol
As famosas receitas de Ana Maria Brogui - As famosas receitas de Ana Maria Brogui
A arte do descaso - A arte do descaso
A arte do Descaso - A arte do Descaso
O Segredo Está Nos Telômeros - O Segredo Está Nos Telômeros
A Louca Debaixo do Branco - A Louca Debaixo do Branco
O Dom da História - O Dom da História
Se a Vida É Um Jogo, Aqui Estão as Regras. - Se a Vida É Um Jogo, Aqui Estão as Regras.
O Design do Dia-a-dia - O Design do Dia-a-dia
Vovô deu no pé - Vovô deu no pé
História Bizarra da Literatura Brasileira - História Bizarra da Literatura Brasileira
Uma Pergunta Por Dia Para Mães - Uma Pergunta Por Dia Para Mães
A Mãe, A Filha e o Espírito da Santa - A Mãe, A Filha e o Espírito da Santa
A Garota do Casaco Azul - A Garota do Casaco Azul
BOX NÃO SE APEGA, NÃO - BOX NÃO SE APEGA, NÃO
A Metamorfose/ Um Artista Da Fome / Carta Ao Pai - A Metamorfose/ Um Artista Da Fome / Carta Ao Pai
Cadu e Mari - Cadu e Mari
Uma Crença Silenciosa em Anjos - Uma Crença Silenciosa em Anjos
O Caçador de Andróides - O Caçador de Andróides
A Síndrome E - A Síndrome E
Circo dos Horrores - Circo dos Horrores
O Órfão de Hitler - O Órfão de Hitler
Vovó Vigarista  - Vovó Vigarista 
O Enigma do Oito - O Enigma do Oito
Peter Pan Tem Que Morrer - Peter Pan Tem Que Morrer
As Lições de Chico Xavier - As Lições de Chico Xavier
Devoradores de Mortos - Devoradores de Mortos
O Assistente de Vampiro - O Assistente de Vampiro
O cérebro que não sabia de nada - O cérebro que não sabia de nada
Mulher-Maravilha: Sementes da Guerra - Mulher-Maravilha: Sementes da Guerra
Peixe Fora D'Água - Peixe Fora D'Água
O Segundo Verão da Irmandade - O Segundo Verão da Irmandade
Além da Magia - Além da Magia
No Meio do Caminho Tinha Um Amor - No Meio do Caminho Tinha Um Amor
O Vôo da Vespa - O Vôo da Vespa
O Voo da Vespa - O Voo da Vespa
A caixa preta - A caixa preta
A Batalha do Avaí - A Batalha do Avaí
Ella Enfeitiçada - Ella Enfeitiçada
As 8 leis espirituais da saúde - As 8 leis espirituais da saúde
Mulheres Alteradas 2 - Mulheres Alteradas 2
Conversas Sobre Educação - Conversas Sobre Educação
Mais Tempo, Mais Dinheiro - Mais Tempo, Mais Dinheiro
As Horas Nuas - As Horas Nuas
As horas nuas - As horas nuas
Fazes-me falta - Fazes-me falta
O Último Catão - O Último Catão
Dentes de Dragão - Dentes de Dragão
O Lado Sujo do Futebol - O Lado Sujo do Futebol
uma rua como aquela - uma rua como aquela
Com amor, Simon - Com amor, Simon
Hotel Valhala: Guia dos Mundos Nórdicos - Hotel Valhala: Guia dos Mundos Nórdicos
Heresia - Heresia
Uma Amizade com Deus - Uma Amizade com Deus
Tudo Se Ilumina - Tudo Se Ilumina
A divina sabedoria dos mestres - A divina sabedoria dos mestres
A Divina Sabedoria dos Mestres - A Divina Sabedoria dos Mestres
Além da Meia-Noite - Além da Meia-Noite
O Alfabeto Perigoso - O Alfabeto Perigoso
As Cinco Fases do Namoro - As Cinco Fases do Namoro
Na Cama com a Fera - Na Cama com a Fera
Diário de Um Zumbi do Minecraft - Diário de Um Zumbi do Minecraft
Muitas Vidas, Uma Só Alma - Muitas Vidas, Uma Só Alma
Nate Volta a Atacar - Nate Volta a Atacar
Pare de Reclamar e Concentre-se nas Coisas Boas - Pare de Reclamar e Concentre-se nas Coisas Boas
Os Últimos Heróis - Os Últimos Heróis
Diário de um Zumbi do Minecraft - Diário de um Zumbi do Minecraft
A vida secreta dos animais - A vida secreta dos animais
Os Corvos de Avalon - Os Corvos de Avalon
Histórias e Conversas de Mulher - Histórias e Conversas de Mulher
Shawn Mendes - Edição Especial para Fãs (Capa Dura) - Shawn Mendes - Edição Especial para Fãs (Capa Dura)
Meu menino vadio - Meu menino vadio
Quando Teresa brigou com Deus - Quando Teresa brigou com Deus
Me dá o TEU contente que eu te dou o MEU - Me dá o TEU contente que eu te dou o MEU
20 Regras de Ouro para Educar Filhos e Alunos - 20 Regras de Ouro para Educar Filhos e Alunos
Cães Educados, Donos Felizes - Cães Educados, Donos Felizes
O bico do tentilhão - O bico do tentilhão
A última carta do tenente - A última carta do tenente
Uma pitada de coragem - Uma pitada de coragem
Para que minha vida se transforme - Para que minha vida se transforme
Xeque-Mate - Xeque-Mate
OTOLINA E A GATA AMARELA - OTOLINA E A GATA AMARELA
Nate está com tudo - Nate está com tudo
Diário de Um Zumbi do Minecraft  - Diário de Um Zumbi do Minecraft 
O Dia Em Que Te Toquei - O Dia Em Que Te Toquei
A Espetacular Vida da Morte - A Espetacular Vida da Morte
O jardineiro que tinha fé - O jardineiro que tinha fé
Senhor Fedor - Senhor Fedor
Como Vencer Gigantes - Como Vencer Gigantes
O Túnel e a Luz - O Túnel e a Luz
Henry, o Corgi da Rainha - Henry, o Corgi da Rainha
Durante Aquele Estranho Chá - Durante Aquele Estranho Chá
Rainha das Copas: Sangue No País das Maravilhas - Rainha das Copas: Sangue No País das Maravilhas
Como o Segredo Mudou Minha Vida - Como o Segredo Mudou Minha Vida
Meia-Noite em Bhopal - Meia-Noite em Bhopal
Minhas Histórias Dos Outros - Minhas Histórias Dos Outros
Luzes, Câmera, Magia.. Os Bastidores de Animais Fantásticos e os Crimes de Grindelwald - Luzes, Câmera, Magia.. Os Bastidores de Animais Fantásticos e os Crimes de Grindelwald
O Arco-Íris de Feynman - O Arco-Íris de Feynman
Doce e Distante - Doce e Distante
O Estranho Caso do Sono Perdido - O Estranho Caso do Sono Perdido
Sou Karol Sevilla - Sou Karol Sevilla
A Casa das Lembranças Perdidas - A Casa das Lembranças Perdidas
Meninos de ouro - Meninos de ouro
O Ponto de Desequilíbrio - O Ponto de Desequilíbrio
O Inverno de Frankie Machine - O Inverno de Frankie Machine
Kiki Strike e a Tumba da Imperatriz - Kiki Strike e a Tumba da Imperatriz
Conversando sobre economia com minha filha - Conversando sobre economia com minha filha
Laços de Amor Eterno - Laços de Amor Eterno
Uma Breve História do Tempo - Uma Breve História do Tempo
O Poder do Encantamento - O Poder do Encantamento
Como o Google Funciona  - Como o Google Funciona 
O mundo segundo Garp - O mundo segundo Garp
Diário De Um Zumbi Do Minecraft  - Diário De Um Zumbi Do Minecraft 
A força da ternura - A força da ternura
As Horas Distantes - As Horas Distantes
Assassinato no Expresso do Oriente - Assassinato no Expresso do Oriente
O milagre de Teresa - O milagre de Teresa
Cadê meu herói? - Cadê meu herói?
501 Grandes Artistas - 501 Grandes Artistas
Kit Livros Isabela Fretas - Não Se Apega não/Não se Iluda não/ Não se Enrola não - Kit Livros Isabela Fretas - Não Se Apega não/Não se Iluda não/ Não se Enrola não
As Extraordinárias Cores Do Amanhã - Pocket - As Extraordinárias Cores Do Amanhã - Pocket
Conversas com um Professor de Literatura - Conversas com um Professor de Literatura
Uma Jornada No Inverno - Uma Jornada No Inverno
Nate é um estouro - Nate é um estouro
Parem A Ivy Pocket - Parem A Ivy Pocket
Jovens Com Atitude Enriquecem Mais Rápido - Jovens Com Atitude Enriquecem Mais Rápido
A felicidade está nas pequenas coisas - A felicidade está nas pequenas coisas
Na Língua dos Bichos - Na Língua dos Bichos
O Menino Múltiplo - O Menino Múltiplo
Príncipe Lestat e Os Reinos de Atlântida - Príncipe Lestat e Os Reinos de Atlântida
Diário de um Zumbi do Minecraft  - Diário de um Zumbi do Minecraft 
O Rosto da Treva - O Rosto da Treva
Quatro Soldados - Quatro Soldados
Virtudes do medo - Virtudes do medo
Naturalmente mais jovem - Naturalmente mais jovem
O Grande Labirinto - O Grande Labirinto
Onde a luz cai - Onde a luz cai
Prelúdio Sombrio - Prelúdio Sombrio
1001 Músicas para Ouvir Antes de Morrer - 1001 Músicas para Ouvir Antes de Morrer
O dia em que Selma sonhou com um ocapi - O dia em que Selma sonhou com um ocapi
Por Uma Fração de Segundo - Por Uma Fração de Segundo
Trilha sonora para o fim dos tempos - Trilha sonora para o fim dos tempos
Vale do Encantamento - Vale do Encantamento
Mestre das Chamas - Mestre das Chamas
Arthur Bispo do Rosário - Arthur Bispo do Rosário
Mozart por trás da máscara - Mozart por trás da máscara
O Encantador de Cães - O Encantador de Cães
Isso me traz alegria - Isso me traz alegria
O Complexo de Atlântida - O Complexo de Atlântida
Consiga o que você quer - Consiga o que você quer
O Horror da Guerra - O Horror da Guerra
O clube da felicidade e da sorte - O clube da felicidade e da sorte
As Tumbas de Atuan - As Tumbas de Atuan
Dexter em Cena - Dexter em Cena
Minha professora é um monstro! (Não Sou, não.) - Minha professora é um monstro! (Não Sou, não.)
Minha vida com meu pai, Leonel Brizola - Minha vida com meu pai, Leonel Brizola
Contagem Regressiva - Contagem Regressiva
Private - Missão Jogos Olímpicos - Private - Missão Jogos Olímpicos
Coração Sombrio - Coração Sombrio
A vida íntima de Laura - A vida íntima de Laura
A Vida Íntima de Laura - A Vida Íntima de Laura
A História Secreta da Criatividade - A História Secreta da Criatividade
O Sobrinho de Wittgenstein - O Sobrinho de Wittgenstein
Como o Cérebro Cria - Como o Cérebro Cria
As mil mortes de César - As mil mortes de César
O manual dos inquisidores - O manual dos inquisidores
O homem que fazia chover - O homem que fazia chover
O que Freud faria? - O que Freud faria?
Box Corte de Espinhos e Rosas 4 Volumes (Acompanha Brindes) - Box Corte de Espinhos e Rosas 4 Volumes (Acompanha Brindes)
International Guy: Londres, Berlim, Washington - International Guy: Londres, Berlim, Washington
Kiki Strike e a Cidade das Sombras - Kiki Strike e a Cidade das Sombras
Meu Jeito Certo de Fazer Tudo Errado - Meu Jeito Certo de Fazer Tudo Errado
Estopinha. A Autobiografia da Vira-Lata Mais Amada do Brasil - Estopinha. A Autobiografia da Vira-Lata Mais Amada do Brasil
Escrevi Isso Pra Você - Escrevi Isso Pra Você
O mistério do coelho pensante - O mistério do coelho pensante
Um ano na selva - Um ano na selva
Sr. Tigre solto na selva  - Sr. Tigre solto na selva 
Fábulas de La Fontaine - Fábulas de La Fontaine
Síndrome de Pinóquio - Síndrome de Pinóquio
Transparências da Eternidade - Transparências da Eternidade
O Dia em que Nate Entrou Para a História - O Dia em que Nate Entrou Para a História
Estúpida, eu? - Estúpida, eu?
1001 Ideias Que Mudaram Nossa Forma de Pensar - 1001 Ideias Que Mudaram Nossa Forma de Pensar
A perigosa idéia de Darwin - A perigosa idéia de Darwin
Um Menino em Um Milhão - Um Menino em Um Milhão
O Amor Existe - O Amor Existe
Os Versos Satânicos - Os Versos Satânicos
Sombrio Perdão - Sombrio Perdão
Box Coleção Ditadura - Box Coleção Ditadura
As Aventuras de Pip - As Aventuras de Pip
Adultos Sem Filtro - Adultos Sem Filtro
A Origem da Espécie Humana - A Origem da Espécie Humana
Do Átomo ao Buraco Negro - Do Átomo ao Buraco Negro
O Homem Duplo - O Homem Duplo
Buracos negros, universos-bebês e outros ensaios - Buracos negros, universos-bebês e outros ensaios
Private - Suspeito Nº 1 - Private - Suspeito Nº 1
O Caso Rembrandt - O Caso Rembrandt
Um Romance Perigoso - Um Romance Perigoso
O boxeador polaco - O boxeador polaco
O Segredo das Sombras - O Segredo das Sombras
Sonhos Lúcidos  - Sonhos Lúcidos 
As Receitas de Elisa Fernandes - As Receitas de Elisa Fernandes
A Fogueira das Vaidades - A Fogueira das Vaidades
Eu Tinha um Cão Negro - Eu Tinha um Cão Negro
Garota Cristã - Garota Cristã
Sob as Cinzas de Stalingrado  - Sob as Cinzas de Stalingrado 
A síndrome de Ulisses - A síndrome de Ulisses
A Vida secreta De Marilyn Moroe - A Vida secreta De Marilyn Moroe
O Quarto do Barba-Azul - O Quarto do Barba-Azul
Da Bauhaus ao Nosso Caos - Da Bauhaus ao Nosso Caos
Dançando o Sonho - Dançando o Sonho
As Extraordinárias Cores do Amanhã - As Extraordinárias Cores do Amanhã
Minha Vida Fora de Série - Minha Vida Fora de Série
Felicidade, Amor e Amizade - Felicidade, Amor e Amizade
Política Para Meu Filho - Política Para Meu Filho
Os sete enforcados - Os sete enforcados
Os Sete Enforcados - Os Sete Enforcados
Um ano na Provence - Um ano na Provence
O que o câncer me ensinou - O que o câncer me ensinou
A Batalha do Apocalipse - A Batalha do Apocalipse
A Viagem do Liberdade - A Viagem do Liberdade
Esquilo Intranquilo - Esquilo Intranquilo
Liderar com o Coração - Liderar com o Coração
Os Sete Últimos Meses De Anne Frank - Pocket - Os Sete Últimos Meses De Anne Frank - Pocket
As surpresas do Pequeno Nicolau - As surpresas do Pequeno Nicolau
A Arte de Animais Fantásticos. Os Crimes de Grindelwald - A Arte de Animais Fantásticos. Os Crimes de Grindelwald
1001 Carros Para Dirigir Antes de Morrer - 1001 Carros Para Dirigir Antes de Morrer
A Cabana - Guia de Estudos - A Cabana - Guia de Estudos
Retrato de Uma Espiã - Retrato de Uma Espiã
Star Wars: A Ascensão e a Queda de Darth Vader - Star Wars: A Ascensão e a Queda de Darth Vader
Coraline : Graphic Novel - Coraline : Graphic Novel
Usain Bolt: Mais Rápido Que Um Raio - Usain Bolt: Mais Rápido Que Um Raio
Libertem a mulher forte - Libertem a mulher forte
Faça você mesmo - Faça você mesmo
A comuna de Paris - A comuna de Paris
Caçada ao Predador - Caçada ao Predador
A Amante do General Japonês - A Amante do General Japonês
O Livro e a Espada - O Livro e a Espada
100 dicas simples para prevenir o Alzheimer - 100 dicas simples para prevenir o Alzheimer
50 Ideias De Economia Que Você Precisa Conhecer - 50 Ideias De Economia Que Você Precisa Conhecer
A Terra das Sombras - A Terra das Sombras
Star Wars: Perseguição ao Jedi - Star Wars: Perseguição ao Jedi
Ladrões de Beleza - Ladrões de Beleza
Dentista sinistra  - Dentista sinistra 
O Beco do Pilão - O Beco do Pilão
Memórias Póstumas de Brás Cubas - Memórias Póstumas de Brás Cubas
Os Segredos Da Vida - Os Segredos Da Vida
O Orgulho de Ser Mulher - O Orgulho de Ser Mulher
Meu jeito certo de fazer tudo errado - Meu jeito certo de fazer tudo errado
Criatividade e Grupos Criativos - Criatividade e Grupos Criativos
O encantador de cavalos - O encantador de cavalos
O Encantador de Cavalos - O Encantador de Cavalos
Setembros de Shiraz - Setembros de Shiraz
Como Conhecer Deus - Como Conhecer Deus
Os Quatro Cavaleiros - Os Quatro Cavaleiros
A Altura Deslumbrante - A Altura Deslumbrante
Chega de Açúcar - Chega de Açúcar
Box - Mario Sergio Cortella - 2 Volumes - Box - Mario Sergio Cortella - 2 Volumes
A Conturbada História das Bibliotecas - A Conturbada História das Bibliotecas
A Política do Rebelde - A Política do Rebelde
O mistério do mapa - O mistério do mapa
A Bela e a Fera. Perdida em Um Livro. Pocket - A Bela e a Fera. Perdida em Um Livro. Pocket
O Artista da Morte - O Artista da Morte
Os Irmãos Tapper Detonam Nova York - Os Irmãos Tapper Detonam Nova York
Algaravias - Algaravias
O Planeta Simbiótico - O Planeta Simbiótico
Os irmãos Tapper detonam Nova York - Os irmãos Tapper detonam Nova York
A verdade segundo Ginny Moon - A verdade segundo Ginny Moon
Com Amor, Simon - Com Amor, Simon
A caixa de natal - A caixa de natal
Canja de galinha para a alma - Canja de galinha para a alma
50 ideias de astronomia que você precisa conhecer - 50 ideias de astronomia que você precisa conhecer
Conselhos para um jovem príncipe - Conselhos para um jovem príncipe
Uma ética para o novo milênio - Uma ética para o novo milênio
GOOGLE - GOOGLE
A Lenda do Violeiro Invejoso - A Lenda do Violeiro Invejoso
A Gatinha Siamesa Chinesa - A Gatinha Siamesa Chinesa
Os Mais Perversos da História - Os Mais Perversos da História
Histórias para Aquecer o Coração das Mulheres - Histórias para Aquecer o Coração das Mulheres
Os Ricos Também Morrem - Os Ricos Também Morrem
Grandes erros - Grandes erros
Emily, The Strange: Duas Vezes Estranha - Emily, The Strange: Duas Vezes Estranha
Jane Precisa de Ajuda - Jane Precisa de Ajuda
A Psicologia do Dinheiro - A Psicologia do Dinheiro
Deu bolo - Deu bolo
À mesa com Monet - À mesa com Monet
Nate está na área - Nate está na área
A Assombrosa Viagem de Pompônio Flato - A Assombrosa Viagem de Pompônio Flato
O Quilombo Orum Aiê - O Quilombo Orum Aiê
Cento e Quatro Cavalos - Cento e Quatro Cavalos
A Criação da Juventude - A Criação da Juventude
O menino que acreditava em milagres - O menino que acreditava em milagres
A Garota Gotic e o Festival mais Assustador que a Morte - A Garota Gotic e o Festival mais Assustador que a Morte
#Por Que Eu Leio - #Por Que Eu Leio
Negociando com os mortos - Negociando com os mortos
A menina de nome enfeitado - A menina de nome enfeitado
Refúgio no Sábado - Refúgio no Sábado
Sobre Demônios e Pecados - Sobre Demônios e Pecados
Dias Raros - Dias Raros
Almanaque Ei, Nerd - Almanaque Ei, Nerd
Nate dá um show - Nate dá um show
Necrópolis - A Batalha das Feras - Necrópolis - A Batalha das Feras
Fronteira Gelada - Fronteira Gelada
A Ética do Rei Menino - A Ética do Rei Menino
O Princípio de Crueldade - O Princípio de Crueldade
Gatomania - Gatomania
Segredos de Nova York - Segredos de Nova York
O Reino Selvagem - O Reino Selvagem
O refúgio do príncipe - O refúgio do príncipe
Mais veja como se faz - Mais veja como se faz
Mulher de Porto Pim - Mulher de Porto Pim
O Hambúrguer era de Carneiro - O Hambúrguer era de Carneiro
De Cinderela a Superexecutica - De Cinderela a Superexecutica
30 dias para mudar  The Whole30 - 30 dias para mudar  The Whole30
Diálogos Criativos - Diálogos Criativos
O Senhor dos Quebra-nozes - O Senhor dos Quebra-nozes
Tudo Começa com a Comida - Tudo Começa com a Comida
25 Verbos Para Construir a Sua Vida - 25 Verbos Para Construir a Sua Vida
O brasil Tatuado e outros mundos - O brasil Tatuado e outros mundos
O Romance dos Espíritos - O Romance dos Espíritos
Abra Sua Mente, Abra sua Vida - Abra Sua Mente, Abra sua Vida
Para Depois que Eu Partir. Pocket - Para Depois que Eu Partir. Pocket
Uma Farmácia para Alma - Uma Farmácia para Alma
O Mistério Quântico - O Mistério Quântico
As Grandes Lições da Vida - As Grandes Lições da Vida
Os Piores Pirralhos do Mundo - Os Piores Pirralhos do Mundo
A Arte de Educar Crianças - A Arte de Educar Crianças
Cinquenta tons mais escuros - Cinquenta tons mais escuros
Bem Sertanejo - Bem Sertanejo
Por que o Sexo é Divertido? - Por que o Sexo é Divertido?
O Poder e a Glória - O Poder e a Glória
O líder sem status: uma parábola - O líder sem status: uma parábola
A incrível verdade sobre as mães - A incrível verdade sobre as mães
O Sonho do Café - O Sonho do Café
Teque, Teque, Muu - Teque, Teque, Muu
Três Caminhos para a Gravidade Quântica - Três Caminhos para a Gravidade Quântica
Sonhos de uma teoria final - Sonhos de uma teoria final
Ligando Os 1000 Pontos: Obras de Arte - Ligando Os 1000 Pontos: Obras de Arte
Star Wars: Uma Nova Esperança. A Vida de Luke Skywalker - Star Wars: Uma Nova Esperança. A Vida de Luke Skywalker
A Descoberta da Tumba de Tutankhamon - A Descoberta da Tumba de Tutankhamon
Descobrindo Sua Força Espiritual  - Descobrindo Sua Força Espiritual 
O Espírito da Filosofia Oriental - O Espírito da Filosofia Oriental
Eu Perdi o Rumo - Eu Perdi o Rumo
Todas as Coisas Belas - Todas as Coisas Belas
Mente, Linguagem e Sociedade - Mente, Linguagem e Sociedade
Mundo fantasmo - Mundo fantasmo
Lampião e Maria Bonita - Lampião e Maria Bonita
Garotas de Xangai - Garotas de Xangai
O rato que roeu o rei - O rato que roeu o rei
Frank Einstein e o Turbocérebro - Frank Einstein e o Turbocérebro
Resgate No Mar - Resgate No Mar
Vingadores ultimato: O anjo pirata, a árvore falante e o capitão guaxinim - Vingadores ultimato: O anjo pirata, a árvore falante e o capitão guaxinim
O Gabinete do Dr. Caligari - O Gabinete do Dr. Caligari
A Princesa de Gelo - A Princesa de Gelo
Harry Potter: Guia Cinematográfico - Harry Potter: Guia Cinematográfico
A Gaiola de Ouro - A Gaiola de Ouro
O Amor me Trouxe de Volta - O Amor me Trouxe de Volta
Conversando com os Espíritos - Conversando com os Espíritos
Alvo Dumbledore: Guia Cinematográfico - Alvo Dumbledore: Guia Cinematográfico
Rony Weasly: Guia Cinematográfico - Rony Weasly: Guia Cinematográfico
Rodrigo: spin-off de TKO Nocaute Técnico - Rodrigo: spin-off de TKO Nocaute Técnico
O Menino de Vestido - O Menino de Vestido
Histórias para Aquecer o Coração dos Adolescentes - Histórias para Aquecer o Coração dos Adolescentes
A Múmia ou Ramsés, o Maldito - A Múmia ou Ramsés, o Maldito
A Ruiva Popstar - A Ruiva Popstar
O Livro Ilustrado dos Maus Argumentos - O Livro Ilustrado dos Maus Argumentos
Tudo que Você Não Soube - Tudo que Você Não Soube
Meu Manifesto pela Terra - Meu Manifesto pela Terra
Meu manifesto pela Terra - Meu manifesto pela Terra
Decodificando o universo - Decodificando o universo
Filha dos Tigres - Filha dos Tigres
Assassinato no expresso oriente - Assassinato no expresso oriente
Ao meu ídolo, com amor - Ao meu ídolo, com amor
Tesouro e Sedução - Tesouro e Sedução
Desvendando o Espiritismo - Desvendando o Espiritismo
Crônicas Selecionadas - Crônicas Selecionadas
O Primeiro Telefonema do Céu - O Primeiro Telefonema do Céu
Batman: Criaturas da Noite - Batman: Criaturas da Noite
A praça do diamente - A praça do diamente
O dia da morte de Denton Little - O dia da morte de Denton Little
Diário Secreto de Ana Bolena - Diário Secreto de Ana Bolena
O Cinema Pensa - O Cinema Pensa
JEAN-BAPTISTE DEBRET - JEAN-BAPTISTE DEBRET
Ligando Os 1000 Pontos: Personalidades - Ligando Os 1000 Pontos: Personalidades
Egitomania: o fascinante mundo do antigo Egito, vol. 2 - Egitomania: o fascinante mundo do antigo Egito, vol. 2
Anão Vestido de Palhaço Mata 8 - Anão Vestido de Palhaço Mata 8
Meu Filho Me Enlouquece! - Meu Filho Me Enlouquece!
Sementes de uma nova Geração - Sementes de uma nova Geração
E As Estrelas, Quantas São? - E As Estrelas, Quantas São?
O Tempo Entre Nós - O Tempo Entre Nós
O Papagaio de Flaubert - O Papagaio de Flaubert
Os Cinco Convites - Os Cinco Convites
Os Irmãos Sisters - Os Irmãos Sisters
O Trílio Negro - O Trílio Negro
A Filha Pródiga - A Filha Pródiga
Fuga Espetacular do Mundo de Minecraft - Fuga Espetacular do Mundo de Minecraft
O Conto da Deusa - O Conto da Deusa
A Improvável Teoria de Ana e Zak - A Improvável Teoria de Ana e Zak
Simples filosofia - Simples filosofia
Faça o seu Coração Vibrar - Faça o seu Coração Vibrar
O Misterioso Lar Cavendish - O Misterioso Lar Cavendish
A Cura Através da Terapia de Vidas Passadas - A Cura Através da Terapia de Vidas Passadas
Rosas de Maio - Rosas de Maio
Comportamento Altamente Ilógico - Comportamento Altamente Ilógico
Um pássaro em vôo - Um pássaro em vôo
Sedução Irresistível - Sedução Irresistível
Amor Súbito - Amor Súbito
Conversando com C.S. Lewis - Conversando com C.S. Lewis
Amante Desperto - Amante Desperto
O Design do futuro - O Design do futuro
O Cemitério dos Vivos - O Cemitério dos Vivos
Pequenos Milagres II - Pequenos Milagres II
Traga Seu Amor de Volta em 21 Dias - Traga Seu Amor de Volta em 21 Dias
A descoberta do Ser - A descoberta do Ser
O CAMINHO PARA O AMOR - O CAMINHO PARA O AMOR
Na Própria Carne - Na Própria Carne
Coisas da Cosa Nostra - Coisas da Cosa Nostra
Amante Sombrio - Amante Sombrio
Eclipse de Deus - Eclipse de Deus
O Gênio da Negociação - O Gênio da Negociação
Um Desafio para Cross - Um Desafio para Cross
Nate dá uma virada - Nate dá uma virada
Histórias para Aquecer o Coração 2 - Histórias para Aquecer o Coração 2
Cozinhe com os monges - Cozinhe com os monges
Cidade Banida - Cidade Banida
O esplendor de Portugal - O esplendor de Portugal
História Bizarra da 2ª Guerra Mundial - História Bizarra da 2ª Guerra Mundial
Tudo é eventual - Tudo é eventual
Diário de Minecraft - Diário de Minecraft
Ligando Os 1000 Pontos: Cidades - Ligando Os 1000 Pontos: Cidades
Cinquenta Tons de Liberdade - Cinquenta Tons de Liberdade
Pantera Negra: O Jovem Príncipe - Pantera Negra: O Jovem Príncipe
Cinquenta Tons de Liberdade - O Capítulo Final - Cinquenta Tons de Liberdade - O Capítulo Final
Cinquenta tons de liberdade - Cinquenta tons de liberdade
Frágil Eternidade - Frágil Eternidade
O caminho de Abraão - O caminho de Abraão
Conversando com Jesus - Conversando com Jesus
Star Wars: Império e Rebelião - Honra entre Ladrões - Star Wars: Império e Rebelião - Honra entre Ladrões
Sociedades Secretas - Maçonaria - Sociedades Secretas - Maçonaria
Era uma vez à meia-noite - Era uma vez à meia-noite
Todas as Cartas - Todas as Cartas
2 Minutes To Midnight - Atlas Ilustrado Do Iron Maiden - 2 Minutes To Midnight - Atlas Ilustrado Do Iron Maiden
As brincadeiras do Pequeno Nicolau - As brincadeiras do Pequeno Nicolau
Olho Mágico - Olho Mágico
O Tapete Voador - O Tapete Voador
Filhos de Sangue e Osso - Filhos de Sangue e Osso
Lobo Alpha - Lobo Alpha
Kintsugi - Kintsugi
Qadehar, o Feiticeiro - Qadehar, o Feiticeiro
Dez bons conselhos de meu pai - Dez bons conselhos de meu pai
O Despertar da Intuição - O Despertar da Intuição
Lidere com humildade - Lidere com humildade
Cura dos oito estagios da vida - Cura dos oito estagios da vida
A Aventura do Estilo - A Aventura do Estilo
Aonde quer que você vá, é você que está lá - Aonde quer que você vá, é você que está lá
Cosmoterapia - Cosmoterapia
Uma Janela para o Amor - Uma Janela para o Amor
A Sedução no Discurso - A Sedução no Discurso
Um Dinheiro Nada Fácil - Um Dinheiro Nada Fácil
O Grito Silencioso - O Grito Silencioso
O balão amarelo - O balão amarelo
A Linguagem das Coisas - A Linguagem das Coisas
A Leitora do Alcorão - A Leitora do Alcorão
A Pérola e a Ostra - A Pérola e a Ostra
Cartas do coração: uma antologia do amor - Cartas do coração: uma antologia do amor
Mel e Amêndoas - Mel e Amêndoas
Adoro Música, Adoro Dançar - Adoro Música, Adoro Dançar
Meu diário (secreto) de anotações do Gravity Falls - Meu diário (secreto) de anotações do Gravity Falls
Aventuras E Desventuras De Tiao E Mané  - Aventuras E Desventuras De Tiao E Mané 
Francisco, nosso Papa - Francisco, nosso Papa
Paisagens da Alma - Paisagens da Alma
Você Pode Ter Saúde, Basta Querer - Você Pode Ter Saúde, Basta Querer
Frutos estranhos - Frutos estranhos
O Risco do Bordado - O Risco do Bordado
Cida, a gata maravilha - Cida, a gata maravilha
Os estagios da meditação - Os estagios da meditação
Qadehar, O Feiticeiro - Qadehar, O Feiticeiro
lições de francês - lições de francês
Doze lendas brasileiras - Doze lendas brasileiras
A África recontada para crianças - A África recontada para crianças
O livro perigoso para garotos (de bolso)  - O livro perigoso para garotos (de bolso) 
Nada para vestir - Nada para vestir
Eu Sou Um Gênio de Maldade Inenarrável e Quero Ser Seu Presidente de Turma - Eu Sou Um Gênio de Maldade Inenarrável e Quero Ser Seu Presidente de Turma
O Pior Emprego Do Mundo - O Pior Emprego Do Mundo
O homem ideal - O homem ideal
Tendência à Distração - Tendência à Distração
Alice Salazar - Alice Salazar
O livro de colorir do Gravity Falls: - O livro de colorir do Gravity Falls:
Em harmonia com a natureza - Em harmonia com a natureza
A Arte de Lidar com Pessoas - A Arte de Lidar com Pessoas
Os Lobos da Invernia - Os Lobos da Invernia
Luta Pela Liberdade - Luta Pela Liberdade
Egitomania: o fascinante mundo do antigo Egito, vol. 4 - Egitomania: o fascinante mundo do antigo Egito, vol. 4
Egitomania: o fascinante mundo do antigo Egito, vol. 3 - Egitomania: o fascinante mundo do antigo Egito, vol. 3
Um Diário Russo - Um Diário Russo
Curso prático de redação - Curso prático de redação
Esqueceram de Mim - Esqueceram de Mim
A Família Urso comendo bobagens demais - A Família Urso comendo bobagens demais
O Grande Roubo do Trem - O Grande Roubo do Trem
Yakov e Os Sete Ladrões - Yakov e Os Sete Ladrões
A Vista Infinita - A Vista Infinita
Sempre Clara Rosa - Sempre Clara Rosa
CORAÇÃO: MANUAL DO PROPRIETÁRIO - CORAÇÃO: MANUAL DO PROPRIETÁRIO
A Jogadora de Go - A Jogadora de Go
A guardiã do portal - A guardiã do portal
Fabricando chocolate - Fabricando chocolate
Dançando Sobre Cacos de Vidro - Dançando Sobre Cacos de Vidro
Água Para Elefantes - Água Para Elefantes
Água para Elefantes - Água para Elefantes
O mistério do coelho pensante e outros contos - O mistério do coelho pensante e outros contos
O Tapete do Rei Salomão - O Tapete do Rei Salomão
O Guia Definitivo Do Mochileiro Das Galáxias + Marcadores Imantados - O Guia Definitivo Do Mochileiro Das Galáxias + Marcadores Imantados
A vida vai dar certo pra mim - A vida vai dar certo pra mim
A Compacta História da Segunda Guerra - A Compacta História da Segunda Guerra
A linguagem das roupas - A linguagem das roupas
Dieta dos Casais - Dieta dos Casais
Reino Animal para colorir e destacar - Reino Animal para colorir e destacar
Quando Nietzsche Chorou - Quando Nietzsche Chorou
O Monge no Jardim - O Monge no Jardim
A Morte é Contagiosa - A Morte é Contagiosa
Egitomania: o fascinante mundo do antigo Egito, vol. 7 - Egitomania: o fascinante mundo do antigo Egito, vol. 7
Egitomania: o fascinante mundo do antigo Egito, vol. 22  - Egitomania: o fascinante mundo do antigo Egito, vol. 22 
Princesa Para Sempre - Princesa Para Sempre
A Lista de Brett - A Lista de Brett
Egitomania: o fascinante mundo do antigo Egito, vol. 6 - Egitomania: o fascinante mundo do antigo Egito, vol. 6
Manhã de Núpcias - Manhã de Núpcias
Egitomania: o fascinante mundo do antigo Egito, vol. 14 - Egitomania: o fascinante mundo do antigo Egito, vol. 14
Egitomania: o fascinante mundo do antigo Egito, vol. 10 - Egitomania: o fascinante mundo do antigo Egito, vol. 10
Egitomania: o fascinante mundo do antigo Egito, vol. 12 - Egitomania: o fascinante mundo do antigo Egito, vol. 12
Egitomania: o fascinante mundo do antigo Egito, vol. 11 - Egitomania: o fascinante mundo do antigo Egito, vol. 11
Egitomania: o fascinante mundo do antigo Egito, vol. 5 - Egitomania: o fascinante mundo do antigo Egito, vol. 5
 As Estratégias Fatais -  As Estratégias Fatais
A Bruxa de Kepler - A Bruxa de Kepler
Star Wars: A Velha República - Revan - Star Wars: A Velha República - Revan
Atenção plena para iniciantes - Atenção plena para iniciantes
Atenção Plena Para Iniciantes - Atenção Plena Para Iniciantes
Atlas dos Lugares Sagrados - Atlas dos Lugares Sagrados
O Espelho Enterrado - O Espelho Enterrado
Egitomania: o fascinante mundo do antigo Egito, vol. 8 - Egitomania: o fascinante mundo do antigo Egito, vol. 8
O ABSURDO E A GRAÇA - O ABSURDO E A GRAÇA
Monte da Alegria - Monte da Alegria
Marte e Vênus Apaixonados - Marte e Vênus Apaixonados
365 Dias Que Mudaram O Mundo - 365 Dias Que Mudaram O Mundo
Olha para o céu, Frederico! - Olha para o céu, Frederico!
Ao Seu Comando - Ao Seu Comando
A Dama e o Unicornio. - A Dama e o Unicornio.
Amante Vingado - Amante Vingado
Obras De Arte Para Colorir - Obras De Arte Para Colorir
Como me tornei freira - Como me tornei freira
Treine seu cérebro para ser feliz - Treine seu cérebro para ser feliz
Deixe a Neve Cair - Deixe a Neve Cair
Deixe a neve cair - Deixe a neve cair
Magia Nossa de Cada Dia - Magia Nossa de Cada Dia
Felipe Bronze: Cozinha brasileira de vanguarda - Felipe Bronze: Cozinha brasileira de vanguarda
A Razão Gulosa - A Razão Gulosa
A flor do Taiti - A flor do Taiti
50 GRANDES MESTRES DO SUCESSO - 50 GRANDES MESTRES DO SUCESSO
Apenas seis números - Apenas seis números
Os sete pecados da memória - Os sete pecados da memória
O PESSIMISMO E SUAS VONTADES - O PESSIMISMO E SUAS VONTADES
Coração de Diamante - Coração de Diamante
O Príncipe dos Canalhas - O Príncipe dos Canalhas
50 ideias de história do mundo que você precisa conhecer - 50 ideias de história do mundo que você precisa conhecer
Nate Bota Pra Quebrar - Nate Bota Pra Quebrar
Minas do Ouro - Minas do Ouro
Histórias e Ensinamentos da Vida de Buda - Histórias e Ensinamentos da Vida de Buda
Roube como um artista: O Diário - Roube como um artista: O Diário
O Pacto Cassandra - O Pacto Cassandra
Romilda e Margarida  - Romilda e Margarida 
A maratona mais louca do mundo! - A maratona mais louca do mundo!
SEU BALDE ESTÁ CHEIO? - SEU BALDE ESTÁ CHEIO?
Encontre Deus Na Cabana - Encontre Deus Na Cabana
Cobra Kai - A Saga Karatê Kid Continua - Cobra Kai - A Saga Karatê Kid Continua
Star Wars - Figuras de Chumbo - 15 - Star Wars - Figuras de Chumbo - 15
Eliminando o estresse - Eliminando o estresse
O Anjo Exterminador - O Anjo Exterminador
As Novas Doenças da Alma - As Novas Doenças da Alma
Star Wars - Figuras de Chumbo - 57 - Star Wars - Figuras de Chumbo - 57
Star Wars - Figuras de Chumbo - 36 - Star Wars - Figuras de Chumbo - 36
Criatividade e Grupos Criativos: Fantasia e Concretude - Vol. 2 - Criatividade e Grupos Criativos: Fantasia e Concretude - Vol. 2
Star Wars - Figuras de Chumbo - 05 - Star Wars - Figuras de Chumbo - 05
A Tentação da Inocência - A Tentação da Inocência
100 promessas para o meu bebê - 100 promessas para o meu bebê
Vire o jogo! - Vire o jogo!
Uma Breve História do Tempo  - Uma Breve História do Tempo 
Uma breve história do tempo - Uma breve história do tempo
Pensar bem, sentir-se bem - Pensar bem, sentir-se bem
Cinquenta Tons Mais Escuros - Cinquenta Tons Mais Escuros
Diário do Subsolo - Diário do Subsolo
Era Uma Vez No Outono - Era Uma Vez No Outono
As Maçãs do Sr. Peabody - As Maçãs do Sr. Peabody
Porque Lulu Bergantim não Atravessou o Rubicon - Porque Lulu Bergantim não Atravessou o Rubicon
BELA MATERNIDADE - BELA MATERNIDADE
Simplesmente o Paraíso - Simplesmente o Paraíso
Contos de Terror do Tio Montague - Contos de Terror do Tio Montague
A Noiva Ladra - A Noiva Ladra
A Ética Romântica e o Espírito do Consumismo Moderno - A Ética Romântica e o Espírito do Consumismo Moderno
Ateliê Fashion: Estampas Para Colorir - Ateliê Fashion: Estampas Para Colorir
A Maré Rebelde - A Maré Rebelde
A História Em Discursos - A História Em Discursos
O novo poder - O novo poder
O Parque dos Dinossauros - O Parque dos Dinossauros
A Terceira Medida do Sucesso - A Terceira Medida do Sucesso
O torcedor acidental - O torcedor acidental
Guadalupe e as bruxas - Guadalupe e as bruxas
João Paulo II  Estou Nas Mãos de Deus - João Paulo II  Estou Nas Mãos de Deus
A Gênese Africana - A Gênese Africana
O executivo sincero - O executivo sincero
Tina - Livro de colorir - Tina - Livro de colorir
A Imbatível Garota-Esquilo - A Imbatível Garota-Esquilo
O Funeral de Chopin - O Funeral de Chopin
O Ônibus Mágico - O Ônibus Mágico
A Estrela Que Nunca Vai Se Apagar - A Estrela Que Nunca Vai Se Apagar
Playboy irresistível - Playboy irresistível
violetas e caracóis - violetas e caracóis
Egitomania: o fascinante mundo do antigo Egito, vol. 29 - Egitomania: o fascinante mundo do antigo Egito, vol. 29
As Batidas Perdidas do Coração - As Batidas Perdidas do Coração
Egitomania: o fascinante mundo do antigo Egito, vol. 28 - Egitomania: o fascinante mundo do antigo Egito, vol. 28
Egitomania: o fascinante mundo do antigo Egito, vol. 21 - Egitomania: o fascinante mundo do antigo Egito, vol. 21
Livro dos Provérbios de Salomão - Livro dos Provérbios de Salomão
A Casa Torta - A Casa Torta
A Máquina Performática - A Máquina Performática
A Lei em Randado - A Lei em Randado
Coraline (Graphic Novel) + O Livro do Cemitério - Coraline (Graphic Novel) + O Livro do Cemitério
Playboy Irresistível - Playboy Irresistível
Baile de máscaras  - Baile de máscaras 
Augusto Cury. O Colecionador de Lágrimas e em Busca do Sentido da Vida - Caixa - Augusto Cury. O Colecionador de Lágrimas e em Busca do Sentido da Vida - Caixa
A escultura de si - A escultura de si
Egitomania: o fascinante mundo do antigo Egito, vol. 27 - Egitomania: o fascinante mundo do antigo Egito, vol. 27
Egitomania: o fascinante mundo do antigo Egito, vol. 18 - Egitomania: o fascinante mundo do antigo Egito, vol. 18
O Despertar do Príncipe - O Despertar do Príncipe
O Julgamento de Gabriel - O Julgamento de Gabriel
O Menino Invisível - O Menino Invisível
Como Treinar o Seu Dragão - Como Treinar o Seu Dragão
Como Treinar O Seu Dragão - Como Treinar O Seu Dragão
O Amor Secreto - O Amor Secreto
Livro de colorir - Mauricio de Sousa 80 anos - Livro de colorir - Mauricio de Sousa 80 anos
Chitty Chitty Bang Bang: o carro mágico - Chitty Chitty Bang Bang: o carro mágico
Egitomania: o fascinante mundo do antigo Egito, vol. 13 - Egitomania: o fascinante mundo do antigo Egito, vol. 13
Você Sempre Jovem - Você Sempre Jovem
Aprendendo a Seduzir - Aprendendo a Seduzir
As Cinco Estações do Corpo - As Cinco Estações do Corpo
A Redenção de Gabriel - A Redenção de Gabriel
21 grandes batalhas que mudaram o Brasil - 21 grandes batalhas que mudaram o Brasil
A Dieta de South Beach Aditivada - A Dieta de South Beach Aditivada
O Inferno de Gabriel - O Inferno de Gabriel
1924 - O Ano Que Criou Hitler - 1924 - O Ano Que Criou Hitler
O cachorro que jogava na ponta esquerda - O cachorro que jogava na ponta esquerda
Amante Meu - Amante Meu
Histórias da América Latina - Histórias da América Latina
Paisagem da Alma - Paisagem da Alma
A Arte da Criatividade - A Arte da Criatividade
Coração de Pedra - Coração de Pedra
Eclipse - Guia Oficial Ilustrado Do Filme - Eclipse - Guia Oficial Ilustrado Do Filme
O código do vestir - O código do vestir
A Tragédia de Macbeth - A Tragédia de Macbeth
Seis Anos Depois - Seis Anos Depois
Um ratástico dia de campeão - Um ratástico dia de campeão
Fizemos bem em resistir - Fizemos bem em resistir
Como Se Livrar de Um Vampiro Apaixonado - Como Se Livrar de Um Vampiro Apaixonado
Novelário de Donga Novais - Novelário de Donga Novais
Tudo o que você precisa saber sobre ciência - Tudo o que você precisa saber sobre ciência
Os hungareses - Os hungareses
O MBA da vida real - O MBA da vida real
Todo Garoto Tem - Todo Garoto Tem
Suíte de silêncios - Suíte de silêncios
Casamento à prova de bebês - Casamento à prova de bebês
Cantando na chuva - Cantando na chuva
Três Coisas Sobre Você - Três Coisas Sobre Você
GARIMPO ou GESTÃO - GARIMPO ou GESTÃO
Máximas do Dirceu - Máximas do Dirceu
Saindo da Depressão - Saindo da Depressão
O Triunfo da Vida - O Triunfo da Vida
Pinte Seu Próprio Van Gogh - Pinte Seu Próprio Van Gogh
Aprendendo a dizer adeus: - Aprendendo a dizer adeus:
O livro quadrado  - O livro quadrado 
Os 27 Desafios Que Todo Chefe Deve Enfrentar - Os 27 Desafios Que Todo Chefe Deve Enfrentar
A Primavera da Srta. Jean Brodie - A Primavera da Srta. Jean Brodie
História das Prisões no Brasil - História das Prisões no Brasil
A Sombra de Heidegger - A Sombra de Heidegger
A Rainha da Fofoca - A Rainha da Fofoca
Diário de um bárbaro covarde - Diário de um bárbaro covarde
Bora enriquecer - Bora enriquecer
Histórias populares da Língua Portuguesa - Histórias populares da Língua Portuguesa
Rodolfo e o Encanto de Natal - Rodolfo e o Encanto de Natal
Cambada de Arruaceiros - Cambada de Arruaceiros
Nossa Senhora Aparecida e o Papa Francisco - Nossa Senhora Aparecida e o Papa Francisco
Mulheres que Correm com os Lobos - Mulheres que Correm com os Lobos
As Aventuras de Dona Friz - Egito Antigo - As Aventuras de Dona Friz - Egito Antigo
Claude Troisgros: histórias, dicas e receitas - Claude Troisgros: histórias, dicas e receitas
365 Tweets de Deus - 365 Tweets de Deus
Eu Posso Fazer Você Feliz - Eu Posso Fazer Você Feliz
Música e Silêncio - Música e Silêncio
O CÍRCULO MÁGICO - O CÍRCULO MÁGICO
As aventuras da dona Friz - Castelo Medieval - As aventuras da dona Friz - Castelo Medieval
Cabala e a arte do tratamento da cura - Cabala e a arte do tratamento da cura
Os Filhos do Capitão Grant - Os Filhos do Capitão Grant
SuperPocoyo - SuperPocoyo
A Sabedoria do Corpo - A Sabedoria do Corpo
As últimas cartas de Jacopo Ortis - As últimas cartas de Jacopo Ortis
Montanhas do Rio - Montanhas do Rio
Bárbara Debaixo da Chuva - Bárbara Debaixo da Chuva
Amante Renascido - Amante Renascido
Quando a Bela Domou a Fera - Quando a Bela Domou a Fera
A Hora do Vampiro - A Hora do Vampiro
O Último dos Canalhas - O Último dos Canalhas
Orfandades - Nova edição: O destino das ausências - Orfandades - Nova edição: O destino das ausências
Querido e Devotado Dexter - Querido e Devotado Dexter
O livro de colorir das criaturas mágicas de Harry Potter - O livro de colorir das criaturas mágicas de Harry Potter
É natal, Stilton - É natal, Stilton
A expedição solar - A expedição solar
A Primeira Chance - A Primeira Chance
Querido vizinho - Querido vizinho
O livro perigoso para garotos (de bolso) - O livro perigoso para garotos (de bolso)
Egitomania: o fascinante mundo do antigo Egito, vol. 9 - Egitomania: o fascinante mundo do antigo Egito, vol. 9
Não Faça Tempestade em Copo D'água com a Família - Não Faça Tempestade em Copo D'água com a Família
Memórias do Abade Choisy vestido de mulher - Memórias do Abade Choisy vestido de mulher
Maquiavel, o poder - Maquiavel, o poder
O mito da masculinidade - O mito da masculinidade
10 histórias para tentar entender um mundo caótico - 10 histórias para tentar entender um mundo caótico
Arquitetura de Um Sonho - Arquitetura de Um Sonho
Como Escrever Textos Técnicos e Profissionais - Como Escrever Textos Técnicos e Profissionais
Amigos e Vinhos, Mulheres à Parte - Amigos e Vinhos, Mulheres à Parte
Eu e Outras Poesias - Eu e Outras Poesias
Sonhos Com Deuses e Monstros - Sonhos Com Deuses e Monstros
O misterioso craque da Vila Belmira - O misterioso craque da Vila Belmira
Seitas, Igrejas e Religiões - Seitas, Igrejas e Religiões
Furacão Dourado - Furacão Dourado
A NOIVA DO CAPITÃO BRIAN - A NOIVA DO CAPITÃO BRIAN
HISTÓRIA E CULTURA AFRICANA E AFRO-BRASILEIRA - HISTÓRIA E CULTURA AFRICANA E AFRO-BRASILEIRA
História e cultura Africana e Afro-Brasileira - História e cultura Africana e Afro-Brasileira
Egitomania: o fascinante mundo do antigo Egito, vol. 19 - Egitomania: o fascinante mundo do antigo Egito, vol. 19
Se o Colégio é um jogo, estas são as regras a violar - Se o Colégio é um jogo, estas são as regras a violar
O Corcel Negro - O Corcel Negro
O navio dos gatos piratas - O navio dos gatos piratas
Mais classificados e nem tanto - Mais classificados e nem tanto
50 ideias de Capitalismo que você precisa conhecer - 50 ideias de Capitalismo que você precisa conhecer
Vou Te Contar  - Vou Te Contar 
O Destino Mora no Coração - O Destino Mora no Coração
O Guia do Líder - O Guia do Líder
O Osso Branco - O Osso Branco
Os Caminhos do Coração - Os Caminhos do Coração
A Vida em Tons de Cinza - A Vida em Tons de Cinza
O Buraco da Agulha - O Buraco da Agulha
Geekerela - Geekerela
O Jardim das Borboletas - O Jardim das Borboletas
A Hora das Bruxas - A Hora das Bruxas
Sedução da Seda - Sedução da Seda
Onze Leis a Cumprir Na Hora de Seduzir - Onze Leis a Cumprir Na Hora de Seduzir
Mais escuro - Mais escuro
Egitomania: o fascinante mundo do antigo Egito, vol. 26 - Egitomania: o fascinante mundo do antigo Egito, vol. 26
Egitomania: o fascinante mundo do antigo Egito, vol. 17 - Egitomania: o fascinante mundo do antigo Egito, vol. 17
O Último Alquimista - O Último Alquimista
As Cinco Pessoas Que Você Encontra no Céu - As Cinco Pessoas Que Você Encontra no Céu
Se Não Houver Amanhã - Se Não Houver Amanhã
As Cinco Pessoas que você Encontra no Céu - As Cinco Pessoas que você Encontra no Céu
Cabala - Alcançando Mundos Superiores - Cabala - Alcançando Mundos Superiores
Egitomania: o fascinante mundo do antigo Egito, vol. 31 - Egitomania: o fascinante mundo do antigo Egito, vol. 31
Egitomania: o fascinante mundo do antigo Egito, vol. 30 - Egitomania: o fascinante mundo do antigo Egito, vol. 30
Egitomania: o fascinante mundo do antigo Egito, vol. 25 - Egitomania: o fascinante mundo do antigo Egito, vol. 25
Star Wars Darth Vader - Figuras de Chumbo - Star Wars Darth Vader - Figuras de Chumbo
Os anos com Laura Díaz - Os anos com Laura Díaz
As cinco pessoas que você encontra no céu - As cinco pessoas que você encontra no céu
Egitomania: o fascinante mundo do antigo Egito, vol. 15 - Egitomania: o fascinante mundo do antigo Egito, vol. 15
Egitomania: o fascinante mundo do antigo Egito, vol. 23 - Egitomania: o fascinante mundo do antigo Egito, vol. 23
Egitomania: o fascinante mundo do antigo Egito, vol. 20 - Egitomania: o fascinante mundo do antigo Egito, vol. 20
Egitomania: o fascinante mundo do antigo Egito, vol. 24 - Egitomania: o fascinante mundo do antigo Egito, vol. 24
Pavarotti - Meu Mundo - Pavarotti - Meu Mundo
Egitomania: o fascinante mundo do antigo Egito, vol. 16 - Egitomania: o fascinante mundo do antigo Egito, vol. 16
Um minuto para a Meia Noite - Um minuto para a Meia Noite
Meditação para a Saúde do Corpo e da Mente - Meditação para a Saúde do Corpo e da Mente
O Pote Mágico - O Pote Mágico
O Doador de Memórias - O Doador de Memórias
As Regras de Ouro dos Casais Saudáveis - As Regras de Ouro dos Casais Saudáveis
A Irmã da Tempestade - A Irmã da Tempestade
Os Tambores de Outono - Os Tambores de Outono
As Vidas de Chico Xavier - As Vidas de Chico Xavier
Os Tambores do Outono - Os Tambores do Outono
À Primeira Vista - À Primeira Vista
O estranho caso dos jogos olímpicos - O estranho caso dos jogos olímpicos
Otolina e A Raposa Roxa - Otolina e A Raposa Roxa
O Princípio do Fim - O Princípio do Fim
A Bela e a Fera (Pocket) - A Bela e a Fera (Pocket)
O Casamento da Princesa - O Casamento da Princesa
Os Doze - Os Doze
Um Passo em Falso - Um Passo em Falso
O homem e seus símbolos - O homem e seus símbolos
Star Wars - Figuras de Chumbo - 29 - Star Wars - Figuras de Chumbo - 29
Star Wars - Figuras de Chumbo - 28 - Star Wars - Figuras de Chumbo - 28
Star Wars - Figuras de Chumbo - 27 - Star Wars - Figuras de Chumbo - 27
Star Wars - Figuras de Chumbo - 22 - Star Wars - Figuras de Chumbo - 22
Star Wars - Figuras de Chumbo - 10 - Star Wars - Figuras de Chumbo - 10
Star Wars - Figuras de Chumbo - 07 - Star Wars - Figuras de Chumbo - 07
Star Wars - Figuras de Chumbo - 06 - Star Wars - Figuras de Chumbo - 06
Egitomania: o fascinante mundo do antigo Egito, vol. 32 - Egitomania: o fascinante mundo do antigo Egito, vol. 32
A Maldição do Espelho - A Maldição do Espelho
Star Wars - Figuras de Chumbo - 20 - Star Wars - Figuras de Chumbo - 20
Star Wars - Figuras de Chumbo - 23 - Star Wars - Figuras de Chumbo - 23
Star Wars - Figuras de Chumbo - 24 - Star Wars - Figuras de Chumbo - 24
Star Wars - Figuras de Chumbo - 25 - Star Wars - Figuras de Chumbo - 25
Star Wars - Figuras de Chumbo - 26 - Star Wars - Figuras de Chumbo - 26
Star Wars - Figuras de Chumbo - 55 - Star Wars - Figuras de Chumbo - 55
Star Wars - Figuras de Chumbo - 60 - Star Wars - Figuras de Chumbo - 60
Star Wars - Figuras de Chumbo - 54 - Star Wars - Figuras de Chumbo - 54
Star Wars - Figuras de Chumbo - 52 - Star Wars - Figuras de Chumbo - 52
Star Wars - Figuras de Chumbo - 58 - Star Wars - Figuras de Chumbo - 58
Star Wars - Figuras de Chumbo - 08 - Star Wars - Figuras de Chumbo - 08
Como montar uma mulher-bomba - Como montar uma mulher-bomba
Star Wars - Figuras de Chumbo - 21 - Star Wars - Figuras de Chumbo - 21
Star Wars - Figuras de Chumbo - 12 - Star Wars - Figuras de Chumbo - 12
Star Wars - Figuras de Chumbo - 09 - Star Wars - Figuras de Chumbo - 09
Star Wars - Figuras de Chumbo - 04 - Star Wars - Figuras de Chumbo - 04
Star Wars - Figuras de Chumbo - 02 - Star Wars - Figuras de Chumbo - 02
Star Wars - Figuras de Chumbo - 18 - Star Wars - Figuras de Chumbo - 18
Star Wars - Figuras de Chumbo - 13 - Star Wars - Figuras de Chumbo - 13
Star Wars - Figuras de Chumbo - 16 - Star Wars - Figuras de Chumbo - 16
Star Wars - Figuras de Chumbo - 34 - Star Wars - Figuras de Chumbo - 34
Star Wars - Figuras de Chumbo - 33 - Star Wars - Figuras de Chumbo - 33
Star Wars - Figuras de Chumbo - 56 - Star Wars - Figuras de Chumbo - 56
Star Wars - Figuras de Chumbo - 40 - Star Wars - Figuras de Chumbo - 40
Star Wars - Figuras de Chumbo - 47 - Star Wars - Figuras de Chumbo - 47
Star Wars - Figuras de Chumbo - 48 - Star Wars - Figuras de Chumbo - 48
Star Wars - Figuras de Chumbo - 41 - Star Wars - Figuras de Chumbo - 41
Star Wars - Figuras de Chumbo - 42 - Star Wars - Figuras de Chumbo - 42
A desconstruçao do Masculino - A desconstruçao do Masculino
Star Wars - Figuras de Chumbo - 39 - Star Wars - Figuras de Chumbo - 39
Transforme Sua Vida com a Cabala - Transforme Sua Vida com a Cabala
Star Wars - Figuras de Chumbo - 49 - Star Wars - Figuras de Chumbo - 49
Star Wars - Figuras de Chumbo - 50 - Star Wars - Figuras de Chumbo - 50
Star Wars - Figuras de Chumbo - 51 - Star Wars - Figuras de Chumbo - 51
Star Wars - Figuras de Chumbo - 43 - Star Wars - Figuras de Chumbo - 43
Star Wars - Figuras de Chumbo - 44 - Star Wars - Figuras de Chumbo - 44
Star Wars - Figuras de Chumbo - 46 - Star Wars - Figuras de Chumbo - 46
Star Wars - Figuras de Chumbo - 31 - Star Wars - Figuras de Chumbo - 31
Star Wars - Figuras de Chumbo - 32 - Star Wars - Figuras de Chumbo - 32
Quem Me Roubou de Mim? - Quem Me Roubou de Mim?
Kama Sutra para a mulher - Kama Sutra para a mulher
O cisne e o aviador - O cisne e o aviador
Novo Manual do FBI para ler a mente das pessoas - Novo Manual do FBI para ler a mente das pessoas
Órfão do destino - Órfão do destino
Destrua Este Diário - Destrua Este Diário
Nos passos de Aladim - Nos passos de Aladim
Gostos adquiridos - Gostos adquiridos
O Tempo entre Costuras - O Tempo entre Costuras
Sob o Céu do Nunca - Sob o Céu do Nunca
Como mudar uma história de dragão - Como mudar uma história de dragão
1001 Filmes Para Ver Antes de Morrer  - 1001 Filmes Para Ver Antes de Morrer 
O Tempo Entre Costuras - O Tempo Entre Costuras
Como quebrar a maldição de um dragão - Como quebrar a maldição de um dragão
Enfeitiçadas - Enfeitiçadas
Como navegar em uma tempestade de dragão - Como navegar em uma tempestade de dragão
Fascinada Por Você - Fascinada Por Você
1001 Filmes para Ver Antes de Morrer - 1001 Filmes para Ver Antes de Morrer
Quando o Amor Bater à Sua Porta - Quando o Amor Bater à Sua Porta
A arte de viver só - A arte de viver só
Três Metros Acima do Céu - Três Metros Acima do Céu
Guia do herói para vencer dragões mortais - Guia do herói para vencer dragões mortais
As Outras Pessoas - As Outras Pessoas
As Duas Guerreiras - As Duas Guerreiras
Se não houver amanhã - Se não houver amanhã
Um Lugar Chamado Liberdade - Um Lugar Chamado Liberdade
Seduzida Por Um Highlander - Seduzida Por Um Highlander
Um lugar chamado liberdade - Um lugar chamado liberdade
A Rainha da Fofoca - Fisgada - A Rainha da Fofoca - Fisgada
Escândalo de Cetim - Escândalo de Cetim
Amigos do oceano - Amigos do oceano
Aprendiz - Aprendiz
Cem Gramas de Centeio - Cem Gramas de Centeio
A Bíblia do Diabo - A Bíblia do Diabo
Jovens de Elite - Jovens de Elite
Apaixonada por Palavras - Apaixonada por Palavras
Curupiras, sacis e outras criaturas fantásticas das florestas - Curupiras, sacis e outras criaturas fantásticas das florestas
A dominatrix gorda - A dominatrix gorda
Quem tem fé não precisa de sorte - Quem tem fé não precisa de sorte
Como Salvar Um Vampiro Apaixonado - Como Salvar Um Vampiro Apaixonado
O caminho da longevidade - O caminho da longevidade
As Regras da Sedução - As Regras da Sedução
Do Cinematoscópio ao Cinema Digital - Do Cinematoscópio ao Cinema Digital
Torne-se mais jovem, viva por mais tempo - Torne-se mais jovem, viva por mais tempo
Herdeiros de Aristóteles - Herdeiros de Aristóteles
Inglês para falar em qualquer situação - Inglês para falar em qualquer situação
Artemis Fowl: O menino prodígio do crime - Artemis Fowl: O menino prodígio do crime
Ao Seu Encontro - Ao Seu Encontro
Sexo sem amor? - Sexo sem amor?
Paixão Índia - Paixão Índia
Um Amor de Cinema - Um Amor de Cinema
A Boa Sorte - A Boa Sorte
A Seita dos Assassinos - A Seita dos Assassinos
Dexter é Delicioso - Dexter é Delicioso
O Guia do Cavalheiro Para o Vício e a Virtude - O Guia do Cavalheiro Para o Vício e a Virtude
Duplo Dexter - Duplo Dexter
A Praça do Diamante - A Praça do Diamante
A Mulher que Escreveu a Bíblia - A Mulher que Escreveu a Bíblia
Crer ou Não Crer - Crer ou Não Crer
Como treinar o seu viking - Como treinar o seu viking
Romance Entre Rendas - Romance Entre Rendas
Crave a Marca - Crave a Marca
A Maldição do Cigano - A Maldição do Cigano
Marte E Venus Recomeçando - Marte E Venus Recomeçando
Volúpia de Veludo - Volúpia de Veludo
50 Ideias de Matemática Que Você Precisa Conhecer - 50 Ideias de Matemática Que Você Precisa Conhecer
Atendimento Nota 10 - Atendimento Nota 10
Orar com o Corpo - Orar com o Corpo
O Homem e sua grande aventura - O Homem e sua grande aventura
Sempre Irresistível - Sempre Irresistível
Operação Cavalo de Tróia 2 - Operação Cavalo de Tróia 2
Tudo É Eventual - Tudo É Eventual
Os Criadores de Coincidências - Os Criadores de Coincidências
Desculpa, Quero Me Casar Contigo - Desculpa, Quero Me Casar Contigo
Histórias da Bíblia Que Se Desdobram à Sua Frente - Histórias da Bíblia Que Se Desdobram à Sua Frente
Manual dos jovens estressados - Manual dos jovens estressados
Cantando a Plenos Pulmões - Cantando a Plenos Pulmões
2025: Caminhos da Cultura no Brasil  - 2025: Caminhos da Cultura no Brasil 
A Irmandade das Calças Viajantes - A Irmandade das Calças Viajantes
O Feiticeiro de Terramar - O Feiticeiro de Terramar
O Cavalo Amarelo - O Cavalo Amarelo
Frederic and Elfrida - Frederic and Elfrida
O Voo da Libélula - O Voo da Libélula
Mulheres de Aço e de Flores - Mulheres de Aço e de Flores
O Segredo de Jasper Jones - O Segredo de Jasper Jones
O Principe de Westeros e Outras Historias - O Principe de Westeros e Outras Historias
O Coronel e o Lobisomem - O Coronel e o Lobisomem
O coronel e o Lobisomem - O coronel e o Lobisomem
Once Upon A Time: Uma Antologia de Contos de Fadas - Once Upon A Time: Uma Antologia de Contos de Fadas
O Psicopata Americano - O Psicopata Americano
Descubra seus Pontos Fortes - Descubra seus Pontos Fortes
O Último Passageiro - O Último Passageiro
Virando a Própria Mesa - Virando a Própria Mesa
A Bruxa de Near - A Bruxa de Near
A Dança da Água - A Dança da Água
A dança da água - A dança da água
Lições do Desejo - Lições do Desejo
Dorothy Tem Que Morrer - Dorothy Tem Que Morrer
O Zoológico de Varsóvia - O Zoológico de Varsóvia
Jesus, o maior líder que já existiu - Jesus, o maior líder que já existiu
Os cadernos de Don Rigoberto - Os cadernos de Don Rigoberto
Vergonha dos Pés - Vergonha dos Pés
Prisioneiro da Noite - Prisioneiro da Noite
A Profecia das Irmãs - A Profecia das Irmãs
Mil dias na Toscana - Mil dias na Toscana
Esquecer o Natal - Esquecer o Natal
A Última Dança de Chaplin - A Última Dança de Chaplin
Cartas de Amor de Paris - Cartas de Amor de Paris
Manual da Mulher Bem Resolvida - Manual da Mulher Bem Resolvida
Google - A História do Negócio de Mídia de Maior Sucesso dos Nossos Tempos - Google - A História do Negócio de Mídia de Maior Sucesso dos Nossos Tempos
Era uma Vez o Amor Mas Tive que Matá-lo - Era uma Vez o Amor Mas Tive que Matá-lo
James Lins - James Lins
A gente se acostuma com o fim do mundo - A gente se acostuma com o fim do mundo
O martelo do Éden - O martelo do Éden
O Que Aconteceu Com Emma - O Que Aconteceu Com Emma
Adorável Cretino 2 - Adorável Cretino 2
Os dias do cervo - Os dias do cervo
Um dia minha alma se abriu por inteiro - Um dia minha alma se abriu por inteiro
A arte de lidar com pessoas - A arte de lidar com pessoas
Bela Gentileza - Bela Gentileza
As Mulheres do Castelo - As Mulheres do Castelo
O Caminho da Tranqüilidade - O Caminho da Tranqüilidade
O Aprendiz do Ladrão de Túmulos - O Aprendiz do Ladrão de Túmulos
Posso conseguir o que desejo - Posso conseguir o que desejo
Uma Professora Fora de Série - Uma Professora Fora de Série
Deus está ao telefone - Deus está ao telefone
Livro Perdido  - Livro Perdido 
Presente do Mar - Presente do Mar
O Livro de Ouro das Revoluções - O Livro de Ouro das Revoluções
A página assombrada por fantasmas - A página assombrada por fantasmas
A pele fria - A pele fria
O Beijo do Otário - O Beijo do Otário
A Espanhola Inglesa - A Espanhola Inglesa
A Canção de Kahunsha - A Canção de Kahunsha
O leitor do trem das 6h27 - O leitor do trem das 6h27
Генезис 2075 - Генезис 2075
Mulheres Inteligentes, Relações Saudáveis - Mulheres Inteligentes, Relações Saudáveis
Por que você não quer mais ir à igreja? - Por que você não quer mais ir à igreja?
O Segredo de Brokeback Mountain - O Segredo de Brokeback Mountain
Leah Fora de Sintonia - Leah Fora de Sintonia
Vastas Emoções e Pensamentos Imperfeitos - Vastas Emoções e Pensamentos Imperfeitos
Ripley debaixo d'Água - Ripley debaixo d'Água
Um caso de necessidade - Um caso de necessidade
As Piores Decisões da História - As Piores Decisões da História
O HOMEM QUE SÓ TINHA CERTEZAS - O HOMEM QUE SÓ TINHA CERTEZAS
O homem que só tinha certezas - O homem que só tinha certezas
97 maneiras de fazer seu Cachorro Sorrir - 97 maneiras de fazer seu Cachorro Sorrir
Pequenos passos para mudar sua vida - Pequenos passos para mudar sua vida
Jogo da Felicidade - Jogo da Felicidade
A Dieta Espiritual - A Dieta Espiritual
A casa da bruxa - A casa da bruxa
Chega de plástico - Chega de plástico
Você foi enganado - Você foi enganado
Pensar com os pés  - Pensar com os pés 
Cartas para Hitler - Cartas para Hitler
Como Adam Smith Pode Mudar Sua Vida - Como Adam Smith Pode Mudar Sua Vida
Timoleon Vieta Volta para Casa - Timoleon Vieta Volta para Casa
Inovadores em Ação - Inovadores em Ação
50 grandes ideias da Humanidade que você precisa conhecer - 50 grandes ideias da Humanidade que você precisa conhecer
As mais lindas histórias de amor da Bíblia - As mais lindas histórias de amor da Bíblia
Aprendendo a lidar com a raiva - Aprendendo a lidar com a raiva
Os Indecentes - Os Indecentes
Sócrates e Thomas More : Correspondências imaginárias - Sócrates e Thomas More : Correspondências imaginárias
Eliminando o Estresse - Eliminando o Estresse
Laços de Amizade - Laços de Amizade
A construção de Madame Mao - A construção de Madame Mao
O Amor Companheiro - O Amor Companheiro
Luz das Runas  - Luz das Runas 
Atenção plena em poucas palavras - Atenção plena em poucas palavras
O Regresso do Catão - O Regresso do Catão
A Contagem Regressiva Matarese - A Contagem Regressiva Matarese
Reciclagem Emocional - Reciclagem Emocional
O HOMEM INSETO ESTÁ VIVO! - O HOMEM INSETO ESTÁ VIVO!
Sobre Fibras e Gente - Sobre Fibras e Gente
Amor Entre Guerras - Amor Entre Guerras
O Último Samurai - O Último Samurai
A Última Gota - A Última Gota
Se a vida é um jogo, estas são as regras - Se a vida é um jogo, estas são as regras
O homem germinal - O homem germinal
O amor me trouxe de volta - O amor me trouxe de volta
Tudo o que você precisa saber sobre a Primeira Guerra Mundial - Tudo o que você precisa saber sobre a Primeira Guerra Mundial
Seduzindo o clube do bolinha - Seduzindo o clube do bolinha
Desmistificando a Maçonaria - Desmistificando a Maçonaria
História da Filosofia Medieval - História da Filosofia Medieval
O caça-uivos - A hora do arrepio - O caça-uivos - A hora do arrepio
O Bicho Folharal - O Bicho Folharal
Do Cinetoscópio ao Cinema Digital - Do Cinetoscópio ao Cinema Digital
Tempestade de Gelo - Tempestade de Gelo
A Caixa dos Perigos - A Caixa dos Perigos
Rádio cidade perdida - Rádio cidade perdida
Noites no circo - Noites no circo
Humana, Demasiado Humana - Humana, Demasiado Humana
Na cabeceira da Cama - Na cabeceira da Cama
Espetinho de gafanhoto, nem pensar ! - Espetinho de gafanhoto, nem pensar !
O Código da Mudança - O Código da Mudança
Killshot Tiro certo - Killshot Tiro certo
Mitos da Saúde - Mitos da Saúde
Se uma criança, numa manhã de verão... - Se uma criança, numa manhã de verão...
A arte de contar histórias - A arte de contar histórias
Contos Orientais - Contos Orientais
A Sinagoga Dos Iconoclastas - A Sinagoga Dos Iconoclastas
Uma longa e estranha viagem - Uma longa e estranha viagem
MERCADORES DE ARTE - MERCADORES DE ARTE
29 minutos para entender a Bíblia - 29 minutos para entender a Bíblia
As Redes da Ilusão - As Redes da Ilusão
A conturbada história das bibliotecas - A conturbada história das bibliotecas
Receitas da Dieta de South Beach - Receitas da Dieta de South Beach
Um Corpo na Biblioteca - Um Corpo na Biblioteca
Os Números da Natureza - Os Números da Natureza
O Último Távora - O Último Távora
Língua de Trapos  - Língua de Trapos 
O Altruísmo e a Moral - O Altruísmo e a Moral
O Agente do Vaticano - O Agente do Vaticano
Rosas de maio - Rosas de maio
O gênio feminino: a vida, a loucura, as palavras - O gênio feminino: a vida, a loucura, as palavras
Viagem para a Felicidade - Viagem para a Felicidade
A Revolta das coisas - A Revolta das coisas
Sabor do Brasil - Sabor do Brasil
As viagens de Francisco - As viagens de Francisco
A Alegria da Meditação - A Alegria da Meditação
O Que Há de Estranho em Mim - O Que Há de Estranho em Mim
Pode beijar a noiva - Pode beijar a noiva
Os Trabalhos de Hércules - Os Trabalhos de Hércules
Dexter no Escuro - Dexter no Escuro
1001 razões para gostar do Rio - 1001 razões para gostar do Rio
AS SETE HISTÓRIAS DE AMOR - AS SETE HISTÓRIAS DE AMOR
50 Tons Mais Escuros - 50 Tons Mais Escuros
Manuscrito encontrado em Accra - Manuscrito encontrado em Accra
Operação Red Sparrow - Operação Red Sparrow
Essa Luz Tão Brilhante - Essa Luz Tão Brilhante
Apenas Um Garoto - Apenas Um Garoto
Manual dos Jovens Estressados - Manual dos Jovens Estressados
A História do Brasil Para Quem Tem Pressa - A História do Brasil Para Quem Tem Pressa
Os Irmãos Sister - Os Irmãos Sister
Encontre Deus na Cabana - Encontre Deus na Cabana
Cem Vinhos Imperdíveis do Guia Descorchados 2009 - Cem Vinhos Imperdíveis do Guia Descorchados 2009
O ditador e a rede - O ditador e a rede
Asesinato en el Orient Express - Asesinato en el Orient Express
Como Fazer um Excelente Currículo - Como Fazer um Excelente Currículo
A Tentação do Coiote - A Tentação do Coiote
Reorganize sua bagagem - Reorganize sua bagagem
VIDA DE MORAVIA - VIDA DE MORAVIA
A descoberta da lentidão - A descoberta da lentidão
As causas da miséria e sua superação - As causas da miséria e sua superação
Meu caderno de estampas - Meu caderno de estampas
João Paulo II - João Paulo II
Lado Profundo Da Vida, O - Como Enfrentar E Superar As Crises Pessoais - Lado Profundo Da Vida, O - Como Enfrentar E Superar As Crises Pessoais
Mulheres De Aço E De Flores - Mulheres De Aço E De Flores
Anitta: O Livro das Poderosas - Pocket - Anitta: O Livro das Poderosas - Pocket
Descendentes 2. Pocket - Descendentes 2. Pocket
Pocoyo. Brinca de Monstro na Minicidade - Pocoyo. Brinca de Monstro na Minicidade
As oito montanhas - As oito montanhas
Mulheres no comando - Mulheres no comando
As Montanhas de Buda - As Montanhas de Buda
As Viagens de Marco Polo - As Viagens de Marco Polo
Pe. Fabio de Melo. O Discípulo da Madrugada, Orfandades e Tempo de Esperas - Caixa - Pe. Fabio de Melo. O Discípulo da Madrugada, Orfandades e Tempo de Esperas - Caixa
Nada a perder 3 - Nada a perder 3
BOX Nada a perder - BOX Nada a perder
O milagre do acaso - O milagre do acaso
O Garoto do Fundo da Sala - O Garoto do Fundo da Sala
O Gênio Feminino - O Gênio Feminino
América cuenta sus mitos - América cuenta sus mitos
Administração de Empresas com Excel - Administração de Empresas com Excel
O Século das Luzes - O Século das Luzes
O Homem do Renascimento - O Homem do Renascimento
No palco todos mundo vira bicho - No palco todos mundo vira bicho
Tesouros da Terra - Tesouros da Terra
Romarias da paixão - Romarias da paixão
O Cofre Do Adhemar  - O Cofre Do Adhemar 
Super Heróis Prontos Para Rockear - Super Heróis Prontos Para Rockear
A Missão Francesa no Brasil - A Missão Francesa no Brasil
O livro de arte (e mistérios...) do Gravity Falls - O livro de arte (e mistérios...) do Gravity Falls
Paris para um e outros contos - Paris para um e outros contos
Box Monja Coen - Vol. 3 - Box Monja Coen - Vol. 3
O princípio do progresso - O princípio do progresso
Sete Ossos e Uma Maldição - Sete Ossos e Uma Maldição
A Ditadura da Beleza e a Revolução das Mulheres - A Ditadura da Beleza e a Revolução das Mulheres
Um Casamento Americano - Um Casamento Americano
Era Uma Vez Minha Primeira Vez - Era Uma Vez Minha Primeira Vez
Harry e Seus Fãs - Harry e Seus Fãs
O Homem Invisível - O Homem Invisível
Paris para Um e Outros Contos - Paris para Um e Outros Contos
O Apanhador de Sonhos - O Apanhador de Sonhos
Vittorio, O Vampiro - Vittorio, O Vampiro
Vittorio, o Vampiro - Vittorio, o Vampiro
A Ruiva Misteriosa - A Ruiva Misteriosa
Tollins 2 - Histórias que são pura dinamite - Tollins 2 - Histórias que são pura dinamite
Star Wars - Figuras de Chumbo - 38 - Star Wars - Figuras de Chumbo - 38
Star Wars - Figuras de Chumbo - 35 - Star Wars - Figuras de Chumbo - 35
POR QUE MARTE E VÊNUS COLIDEM - POR QUE MARTE E VÊNUS COLIDEM
O Segredo das Pessoas Carismáticas. Pocket - O Segredo das Pessoas Carismáticas. Pocket
Os adolescentes aprendem o que vivenciam - Os adolescentes aprendem o que vivenciam
Dez Leis para Ser Feliz - Dez Leis para Ser Feliz
Dez Leis Para Ser Feliz - Dez Leis Para Ser Feliz
Passageiro para Frankfurt - Passageiro para Frankfurt
De Volta à Cabana - De Volta à Cabana
O Grande Livro do Bebê - O Grande Livro do Bebê
A mulher que eles chamavam fatal - A mulher que eles chamavam fatal
Star Wars - Figuras de chumbo - 17 - Star Wars - Figuras de chumbo - 17
Star Wars - Figuras de Chumbo - 14 - Star Wars - Figuras de Chumbo - 14
Star Wars - Figuras de Chumbo - 19 - Star Wars - Figuras de Chumbo - 19
Star Wars - Figuras de Chumbo - 53 - Star Wars - Figuras de Chumbo - 53
Star Wars - Figuras de Chumbo - 59 - Star Wars - Figuras de Chumbo - 59
Star Wars - Figuras de Chumbo - 45 - Star Wars - Figuras de Chumbo - 45
Sacher-Masoch: 1836 - 1895 - Sacher-Masoch: 1836 - 1895
O Bastardo da Rainha (The Quenn's Bastard) - O Bastardo da Rainha (The Quenn's Bastard)
Rocco e seus irmãos - Rocco e seus irmãos
ESTILO IPANEMA - ESTILO IPANEMA
Crónica do rei pasmado - Crónica do rei pasmado
O Livro de colorir de Stars Wars - O Livro de colorir de Stars Wars
Manual da Futura Mamãe - Manual da Futura Mamãe
Star Wars - Figuras de Chumbo - 30 - Star Wars - Figuras de Chumbo - 30
Adultério - Adultério
Contos de humor - Contos de humor
Férias Pagãs - Férias Pagãs
Aprendendo a se relacionar com a riqueza - Aprendendo a se relacionar com a riqueza
Essa ideia é tão boa que parece que foi sua - Essa ideia é tão boa que parece que foi sua
O império da necessidade - O império da necessidade
O Enigma do Quatro - O Enigma do Quatro
Você quer ser um MILIONÁRIO? - Você quer ser um MILIONÁRIO?
Sete Contos de Arrepiar - Sete Contos de Arrepiar
A Palavra Ausente - A Palavra Ausente
Orgulho e Preconceito e Zumbis - Orgulho e Preconceito e Zumbis
A Viagem ao Brasil de Marianne North - A Viagem ao Brasil de Marianne North
Camisa, short e meião - Camisa, short e meião
Um milagre em equilíbrio - Um milagre em equilíbrio
Multilateralismo na Ásia Oriental - Multilateralismo na Ásia Oriental
Meditações Diárias para Mulheres Que Amam Demais - Meditações Diárias para Mulheres Que Amam Demais
As Plantas e Sua Magia - As Plantas e Sua Magia
A Fronteira de Cristal - A Fronteira de Cristal
Promessas que os amantes fazem quando já é tarde demais  - Promessas que os amantes fazem quando já é tarde demais 
A força do passado - A força do passado
Criança pensa - Criança pensa
A estrada de Salamanca - A estrada de Salamanca
Sai pra lá, mané! - Sai pra lá, mané!
Antologia do Retrato - Antologia do Retrato
No Ardor das Chamas - No Ardor das Chamas
A Princesa Virgem - Prelúdio do Trono (Virgin. Prelude to the Throne) - A Princesa Virgem - Prelúdio do Trono (Virgin. Prelude to the Throne)
Um Caso Para Miss Maple - Um Caso Para Miss Maple
Um Toque de Limão - Um Toque de Limão
Santos-Dumont Número 8 - Santos-Dumont Número 8
Minha paixão pelo futebol - Minha paixão pelo futebol
O Nada que Existe - O Nada que Existe
Oração da Serenidade - Oração da Serenidade
Pinte Seu Próprio Monet - Pinte Seu Próprio Monet
O Movimento Romântico: Sexo, Consumo e o Romance - O Movimento Romântico: Sexo, Consumo e o Romance
Carlos Diegues - Carlos Diegues
Ópera dos Fantoches - Ópera dos Fantoches
Guia do leitor para Uma breve história do tempo de Stephen Hawking - Guia do leitor para Uma breve história do tempo de Stephen Hawking
Por que os Homens Amam as Mulheres Poderosas? - Por que os Homens Amam as Mulheres Poderosas?
Juventude em Êxtase - Juventude em Êxtase
Cachos e Tranças - Cachos e Tranças
Oito Vias Para Ser Feliz - Oito Vias Para Ser Feliz
Aventura Animal - Aventura Animal
Hotel Valhala: Guia dos mundos nórdicos - Hotel Valhala: Guia dos mundos nórdicos
Por que os homens me procuram - Por que os homens me procuram
Ethos Mundial - Ethos Mundial
A Morte É Um Número Par - A Morte É Um Número Par
O Quark e o Jaguar - O Quark e o Jaguar
Dupla obsessão - Dupla obsessão
Meu pai, seu porco e eu - Meu pai, seu porco e eu
Um bobo em cada ponta - Um bobo em cada ponta
Amor sem frescura - Amor sem frescura
Minu, o gato azul - Minu, o gato azul
Qualquer Ferro Velho - Qualquer Ferro Velho
A segunda vida de Brás Cubas - A segunda vida de Brás Cubas
A História de Dani-Boy - A História de Dani-Boy
Caco e o Maloquim - Caco e o Maloquim
Carta Aberta Para Minha Mae - Carta Aberta Para Minha Mae
Como Obter o que Você Quer e Apreciar o que Tem - Como Obter o que Você Quer e Apreciar o que Tem
O Homem que Confundiu seu Trabalho com a Vida - O Homem que Confundiu seu Trabalho com a Vida
O Transponível Super Empty - O Transponível Super Empty
A Bíblia do MMA - A Bíblia do MMA
Nos passos de... Cristóvão Colombo - Nos passos de... Cristóvão Colombo
A Arte da Atenção - A Arte da Atenção
Se você é tão esperto, por que não é feliz? - Se você é tão esperto, por que não é feliz?
Os fantasmas e a bruxa - Os fantasmas e a bruxa
Um Século de Paulo Gracindo - Um Século de Paulo Gracindo
Brincando de Folclore - Brincando de Folclore
Espartilhos e Sutiãs: uma História da Sedução - Espartilhos e Sutiãs: uma História da Sedução
200 Receitas de Bons Carboidratos - 200 Receitas de Bons Carboidratos
O Guardião de Memórias - O Guardião de Memórias
O que Nietzsche faria? - O que Nietzsche faria?
O Laço cor-de-rosa - O Laço cor-de-rosa
 Meu Pequeno Lobisomem -  Meu Pequeno Lobisomem
Romantize Seus Negócios - Romantize Seus Negócios
Como Fazer as Pessoas Gostarem de Você a Primeira Vista - Como Fazer as Pessoas Gostarem de Você a Primeira Vista
Rita e o Treco - Rita e o Treco
Salsicha quer falar - Salsicha quer falar
Adão no Éden - Adão no Éden
A mulher positiva - A mulher positiva
O Bandido Que Todos Procuramos - O Bandido Que Todos Procuramos
Coisa de negros - Coisa de negros
Os pergaminhos do Mar Morto - Os pergaminhos do Mar Morto
Seu sexto sentido - Seu sexto sentido
O Corpo Humano - O Corpo Humano
Minha vida com mamãe - Minha vida com mamãe
A Gralha-Azul e Sua Lenda - A Gralha-Azul e Sua Lenda
Um traidor da memória - Um traidor da memória
Cultivando a saúde do corpo e da mente - Cultivando a saúde do corpo e da mente
O filho de Lázaro - O filho de Lázaro
Os Caçadores de Recompensas - Os Caçadores de Recompensas
A Disciplina Dos Lideres De Mercado - A Disciplina Dos Lideres De Mercado
A vida antes do homem - A vida antes do homem
O Livro dos livros - O Livro dos livros
Uma História Descomplicada da Filosofia - Uma História Descomplicada da Filosofia
Pequeno livro de etiqueta - Pequeno livro de etiqueta
Pense Positivo Todos os Dias - Pense Positivo Todos os Dias
Mindfulness Para Uma Vida Melhor - Mindfulness Para Uma Vida Melhor
O redemunho do horror - O redemunho do horror
A Realização Espontânea do Desejo - A Realização Espontânea do Desejo
clara rosa quer uma chance - clara rosa quer uma chance
Platão no país dos paradoxos - Platão no país dos paradoxos
Trilha do Destino - Trilha do Destino
O melhor do Cortella - O melhor do Cortella
O Senhor da Guerra - O Senhor da Guerra
O Cristo Cósmico e os Essênios - O Cristo Cósmico e os Essênios
Biografia não autorizada do Vaticano - Biografia não autorizada do Vaticano
O clã de Rhett Buttler - O clã de Rhett Buttler
O dilema americano - O dilema americano
Loucura de Hamlet - Loucura de Hamlet
Amigos da Selva - Amigos da Selva
As 5 Leis Para o Líder de Sucesso - As 5 Leis Para o Líder de Sucesso
Espelho, espelho meu, quem sou eu? - Espelho, espelho meu, quem sou eu?
Madame Oráculo - Madame Oráculo
As Aventuras de Abdi - As Aventuras de Abdi
Homens, mulheres e relacionamentos - Homens, mulheres e relacionamentos
A Beleza da Fera - A Beleza da Fera
Nao faca temepstade em copo d'agua para adolescentes - Nao faca temepstade em copo d'agua para adolescentes
Ao Meu Ídolo, com Amor - Ao Meu Ídolo, com Amor
A Origem do Universo - A Origem do Universo
Platão para Sonhadores - Platão para Sonhadores
Inglês para redação e leitura - Inglês para redação e leitura
O romance de Maria Madalena - O romance de Maria Madalena
A Cauda de Emília Ventania - A Cauda de Emília Ventania
Coelho Corre - Coelho Corre
O Movimento Romântico - O Movimento Romântico
O Mundo Mágico de Harry Potter - O Mundo Mágico de Harry Potter
Hipnose para Iniciantes - Hipnose para Iniciantes
O que Faria Maquiavel? - O que Faria Maquiavel?
Gatos, Fio Dentais e Amassos - Gatos, Fio Dentais e Amassos
Bodas de Ouro em Yquem - Bodas de Ouro em Yquem
Você tem boa memória? - Você tem boa memória?
Tão longo amor tão curta a vida - Tão longo amor tão curta a vida
Freud e a questão da religião - Freud e a questão da religião
Como memorizar tudo o que quiser - Como memorizar tudo o que quiser
O Outro Lado da Noite: Filme Noir - O Outro Lado da Noite: Filme Noir
Tony e Susan - Tony e Susan
A Economia do Ócio - A Economia do Ócio
Sonhos de sonhos - Sonhos de sonhos
Sétimo Céu - Sétimo Céu
Balzac - Balzac
As Sociedades Secretas mais Perversas da História - As Sociedades Secretas mais Perversas da História
A Panqueca Fugitiva, O Resmungão e Outros Contos Nórdicos - A Panqueca Fugitiva, O Resmungão e Outros Contos Nórdicos
50 Ideias de Matemática Que Você Precisa Saber - 50 Ideias de Matemática Que Você Precisa Saber
Mulheres às avessas - Mulheres às avessas
Cada vez eu quero mais - Cada vez eu quero mais
Mãe, me ensina a conversar - Mãe, me ensina a conversar
Amar, Verbo Atemporal - Amar, Verbo Atemporal
A Guerra do Rock - A Guerra do Rock
O jogo do Trabalho - O jogo do Trabalho
Corintiano Graças a Deus - Corintiano Graças a Deus
Ornamento e modernismo - Ornamento e modernismo
Dança, Sexo e Gênero - Dança, Sexo e Gênero
1001 MANEIRAS DE TOMAR A INICIATIVA NO TRABALHO - 1001 MANEIRAS DE TOMAR A INICIATIVA NO TRABALHO
O Erotismo - O Erotismo
Frutos da paixão - Frutos da paixão
Uma outra chance para a felicidade - Uma outra chance para a felicidade
Casa de Família - Casa de Família
Tempo de Transcedência - Tempo de Transcedência
Desejos Macabros - Desejos Macabros
Catapora não se come, Clara Rosa - Catapora não se come, Clara Rosa
 Você é mais capaz do que pensa -  Você é mais capaz do que pensa
Capitã Marvel - Capitã Marvel
Como trabalhar com pessoas difíceis - Como trabalhar com pessoas difíceis
Casar Sem Frescura - Casar Sem Frescura
Clara Rosa Está Murchinha - Clara Rosa Está Murchinha
Noturno Indiano - Noturno Indiano
Os Espelhos do Tempo - Os Espelhos do Tempo
Filha das Trevas - Filha das Trevas
Deixe seu cérebro em forma - Deixe seu cérebro em forma
Vendedor Falcão - Vendedor Falcão
Homens Que Odeiam Suas Mulheres & As mulheres que os amam - Homens Que Odeiam Suas Mulheres & As mulheres que os amam
O armário da bruxa - O armário da bruxa
Um homem apaixonado - Um homem apaixonado
A Década Roubada - A Década Roubada
Muncle Trogg e o Burro Voador - Muncle Trogg e o Burro Voador
Advogado do Diabo - Advogado do Diabo
Diário de um Skinhead - Diário de um Skinhead
Pique-Susto - Pique-Susto
O que aprendemos com os Gatos - O que aprendemos com os Gatos
Oficina do Empreendedor - Oficina do Empreendedor
O corpo dela e outras farras - O corpo dela e outras farras
Schifaizfavoire - Schifaizfavoire
Como planejar e conduzir reuniões produtivas - Como planejar e conduzir reuniões produtivas
O Caminho para Omaha - O Caminho para Omaha
A Tarde de Um Escritor - A Tarde de Um Escritor
Destrua Este Diário. Silvertape - Destrua Este Diário. Silvertape
O Livro das Cortesãs - O Livro das Cortesãs
O Último Posto do Rio Sabre - O Último Posto do Rio Sabre
Anjos à Nossa Volta - Anjos à Nossa Volta
Primeiro Amor, Último Sacramento e Entre Lençóis - Primeiro Amor, Último Sacramento e Entre Lençóis
Meditações para a manhã e a noite - Meditações para a manhã e a noite
Para que trabalho você foi feito? - Para que trabalho você foi feito?
Não espere pelo príncipe encantado - Não espere pelo príncipe encantado
A Rebelião dos Coelhos Mágicos - A Rebelião dos Coelhos Mágicos
A Casa de Chocolate - A Casa de Chocolate
Quatro estações em Roma - Quatro estações em Roma
Primatas da Park Avenue - Primatas da Park Avenue
Os órfãos de Ruanda - Os órfãos de Ruanda
À espera dos filhos da luz - À espera dos filhos da luz
Tipos Incomuns (Algumas Histórias) - Tipos Incomuns (Algumas Histórias)
Frida Kahlo para inconformistas - Frida Kahlo para inconformistas
O segredo das Pessoas Carismáticas - O segredo das Pessoas Carismáticas
Meditando com Brian Weiss - Meditando com Brian Weiss
#FALSIANE - #FALSIANE
O livro das perfídias profanas - O livro das perfídias profanas
O cofre do Adhemar - O cofre do Adhemar
Só Para Mulheres - Só Para Mulheres
A segunda pátria - A segunda pátria
Eu era uma ótima mãe até ter filhos - Eu era uma ótima mãe até ter filhos
Os Amores de Honey - Os Amores de Honey
Nos passos dos... Deuses do Egito - Nos passos dos... Deuses do Egito
Confissões de Inverno - Confissões de Inverno
Barbara Debaixo Da Chuva - Barbara Debaixo Da Chuva
Zé Perri - Zé Perri
O Aprendiz de Gutenberg - O Aprendiz de Gutenberg
Ponche de rum - Ponche de rum
Admirador Secreto - Admirador Secreto
A Criação de Mitos na Publicidade - A Criação de Mitos na Publicidade
Bolsas, Beijos e Brigadeiros - Bolsas, Beijos e Brigadeiros
As Piores Invenções da História - As Piores Invenções da História
Um planeta em seu giro veloz - Um planeta em seu giro veloz
Um Planeta em Seu Giro Veloz - Um Planeta em Seu Giro Veloz
O Último Patriota - O Último Patriota
Aprendendo a vencer o medo - Aprendendo a vencer o medo
Marte E Venus Juntos Para Sempre - Marte E Venus Juntos Para Sempre
O Pintor de Pássaros - O Pintor de Pássaros
Aprendendo a gostar de si mesmo - Aprendendo a gostar de si mesmo
Sob o Sol da Toscana - Sob o Sol da Toscana
As Rosas Inglesas - As Rosas Inglesas
Areias do Tempo - Areias do Tempo
Orfandades - Orfandades
Tinta Perigosa - Tinta Perigosa
Ratobúrguer - Ratobúrguer
Diana ou a caçadora solitária - Diana ou a caçadora solitária
365 dias que mudaram o Brasil - 365 dias que mudaram o Brasil
Bruno e a Maldição da Serpente - Bruno e a Maldição da Serpente
O melhor de Cortella - O melhor de Cortella
As regras mudaram - As regras mudaram
Valdez Vem Aí - Valdez Vem Aí
Histórias de Homens Casados - Histórias de Homens Casados
Dexter Está Morto - Dexter Está Morto
Paisagem de porcelana - Paisagem de porcelana
Nossas fantasias mais íntimas - Nossas fantasias mais íntimas
A Idade Secreta - A Idade Secreta
1000 Lugares para Conhecer Antes de Morrer - 1000 Lugares para Conhecer Antes de Morrer
Edgar e Ellen Armadilha para Turista - Edgar e Ellen Armadilha para Turista
A Farsa de Prometeu - A Farsa de Prometeu
Marte e Vênus no Quarto - Marte e Vênus no Quarto
Histórias para aquecer os corações dos adolescentes - Histórias para aquecer os corações dos adolescentes
De lagarta a borboleta - De lagarta a borboleta
A Morte Como Despertar - A Morte Como Despertar
João Guilherme na Estrada - João Guilherme na Estrada
Sammy Keyes e o homem esqueleto - Sammy Keyes e o homem esqueleto
A Décima Terceira Marian - A Décima Terceira Marian
Homens com mulheres - Homens com mulheres
A Vingança do Povo das Sombras - A Vingança do Povo das Sombras
Micos e Outros Bichos  - Micos e Outros Bichos 
As Pupilas do Senhor Reitor - As Pupilas do Senhor Reitor
Cântico de Sangue - Cântico de Sangue
Yaqui Delgado quer quebrar a sua cara - Yaqui Delgado quer quebrar a sua cara
Yaqui Delgado Quer Quebrar a Sua Cara - Yaqui Delgado Quer Quebrar a Sua Cara
O Último Jurado - O Último Jurado
A Classe Não Está Dispensada - A Classe Não Está Dispensada
Não faça tempestade em copo d'água Para Adolescentes - Não faça tempestade em copo d'água Para Adolescentes
Emília Ventania em a Sereiazinha e o Monstro do Mar  - Emília Ventania em a Sereiazinha e o Monstro do Mar 
Mr. Sebastian e o Fantástico Mágico Negro - Mr. Sebastian e o Fantástico Mágico Negro
Malditas Mulheres - Malditas Mulheres
Confissões Verídicas de Um Terrorista Albino - Confissões Verídicas de Um Terrorista Albino
Como sobreviver em Família - Como sobreviver em Família
Os Filhos do Graal - Os Filhos do Graal
Um Natal Assombrado - Um Natal Assombrado
A Cidade dos Cisnes - A Cidade dos Cisnes
Gafes no Palácio - Gafes no Palácio
Mentiras Essenciais, verdades simples - Mentiras Essenciais, verdades simples
O potencial erótico de minha mulher - O potencial erótico de minha mulher
Cartas do inferno - Cartas do inferno
Mulheres à Beira de Um Ataque de Nervos - Mulheres à Beira de Um Ataque de Nervos
Território dos sonhos - Território dos sonhos
A Marca do Assassino - A Marca do Assassino
O Futebol Levado a Riso - O Futebol Levado a Riso
Larga Quem Não Te Agarra - Larga Quem Não Te Agarra
Os Heróis de esparta - Os Heróis de esparta
A História de Amalia - A História de Amalia
Uma História de Família - Uma História de Família
A Magia da Camisa 10 - A Magia da Camisa 10
Correio para Mulheres - Correio para Mulheres
Os seios de Pandora - Os seios de Pandora
Um Olho na Bola, outro no Cartola - Um Olho na Bola, outro no Cartola
A Maquina Voadora - A Maquina Voadora
Debaixo das rodas de um automóvel - Debaixo das rodas de um automóvel
O arqueólogo do futuro - O arqueólogo do futuro
O arqueólogo do Futuro - O arqueólogo do Futuro
Por que As Mulheres Escrevem Mais Cartas Do Que Enviam ? - Por que As Mulheres Escrevem Mais Cartas Do Que Enviam ?
O Adultério em 10 Lições - O Adultério em 10 Lições
Hemingway no Amor e na Guerra - Hemingway no Amor e na Guerra
Os Ditadores mais Perversos da História - Os Ditadores mais Perversos da História
Caderno de Rabiscos para Adultos Entediados no Trabalho - Caderno de Rabiscos para Adultos Entediados no Trabalho
Cães Negros - Cães Negros
O Príncipe e Outras Fábulas Modernas - O Príncipe e Outras Fábulas Modernas
A casa das Sete Irmãs - A casa das Sete Irmãs
O Amante do Vulcão - O Amante do Vulcão
Não Faça Tempestade Em Copo D'Água No Amor - Não Faça Tempestade Em Copo D'Água No Amor
Descobrindo a alegria de viver - Descobrindo a alegria de viver
Pare de fazer drama e aproveite a vida - Pare de fazer drama e aproveite a vida
Aprendendo a Viver Plenamente - Aprendendo a Viver Plenamente
Amor, Perdas e Meus Vestidos - Amor, Perdas e Meus Vestidos
O Mundo Sutil do Amor - O Mundo Sutil do Amor
REENGENHARIA DO TEMPO - REENGENHARIA DO TEMPO
O velho e os lobos - O velho e os lobos
O poder do fracasso - O poder do fracasso
Clara Rosa não é nome de flor - Clara Rosa não é nome de flor
A Voz no Espelho - A Voz no Espelho
O Livro dos Horrores - O Livro dos Horrores
O império do oprimido - O império do oprimido
A Arte da Guerra Para Quem Mexeu No Queijo Do Pai Rico - A Arte da Guerra Para Quem Mexeu No Queijo Do Pai Rico
As 17 cores do branco - As 17 cores do branco
Prenda-me, por favor - Prenda-me, por favor
Rumo a outro verão - Rumo a outro verão
Amar de Olhos Abertos - Amar de Olhos Abertos
Dicionário: O Pequeno Rebelde - Dicionário: O Pequeno Rebelde
Um Momento de Louros Verdes - Um Momento de Louros Verdes
Pequeno tratado da intolerância - Pequeno tratado da intolerância
Tanglewreck: O Guardião do Tempo - Tanglewreck: O Guardião do Tempo
Eu sou Charlotte Simmons - Eu sou Charlotte Simmons
Minha Jornada Além da Vida - Minha Jornada Além da Vida
Meu Pescoço é um Horror - Meu Pescoço é um Horror
Nada Certo em Saideperto - Nada Certo em Saideperto
A Arte de se Fazer Respeitar - A Arte de se Fazer Respeitar
Historias horripilantes demais para se contar no acampamento - Historias horripilantes demais para se contar no acampamento
Cavalos Roubados - Cavalos Roubados
História Revelada da SS - História Revelada da SS
Na Corda Bamba - Na Corda Bamba
Guia Definitivo de League of Legends - Guia Definitivo de League of Legends
clara rosa vê vermelho - clara rosa vê vermelho
Melhores Amigas Para Sempre - Melhores Amigas Para Sempre
A criança no tempo - A criança no tempo
Uma História de Amor Real e Supertriste - Uma História de Amor Real e Supertriste
Céu de Tango - Céu de Tango
O Segredo Para Emagrecer - O Segredo Para Emagrecer
Gossip Girl : Eu Não Mentiria Pra Você  - Gossip Girl : Eu Não Mentiria Pra Você 
Confissões de um pai Doméstico - Confissões de um pai Doméstico
Rosto de Caveira, Os Filhos da Noite e Outros Contos - Rosto de Caveira, Os Filhos da Noite e Outros Contos
O que todo jovem talento precisa aprender - O que todo jovem talento precisa aprender
A Carta Esférica - A Carta Esférica
Mulheres solteiras não são de Marte - Mulheres solteiras não são de Marte
Entre o Céu e a Terra  - Entre o Céu e a Terra 
Valentões, fofoqueiros e falsos amigos - Valentões, fofoqueiros e falsos amigos
1001 razões para gostar do Brasil - 1001 razões para gostar do Brasil
Puxa, qual bruxa? - Puxa, qual bruxa?
O perfume da folha de limão - O perfume da folha de limão
Garotos Malditos - Garotos Malditos
Quando as mulheres saem para dançar - Quando as mulheres saem para dançar
Em caso de felicidade - Em caso de felicidade
Beije-me Onde o Sol Não Alcança - Beije-me Onde o Sol Não Alcança
A paixão de Maria Madalena - A paixão de Maria Madalena
Aconteceu em Blackrock - Aconteceu em Blackrock
Batons, assassinatos e profetas - Batons, assassinatos e profetas
O Caminho Para Gandolfo - O Caminho Para Gandolfo
Verão Diabólico - Verão Diabólico
O diário de Rutka - O diário de Rutka
Hermann Hesse para desorientados - Hermann Hesse para desorientados
As Vantagens de Ser Otimista - As Vantagens de Ser Otimista
Jane Austen Roubou Meu Namorado - Jane Austen Roubou Meu Namorado
Ao Deus-Dará - Ao Deus-Dará
Duendes, Gigantes e Outros Seres Fantásticos - Duendes, Gigantes e Outros Seres Fantásticos
A Fascinação pelo Pior - A Fascinação pelo Pior
O Colecionador de Colecionadores - O Colecionador de Colecionadores
Feng Shui no trabalho - Feng Shui no trabalho
Lições de amor - Lições de amor
Quero Construir a Minha História - Quero Construir a Minha História
Como Proust pode mudar Sua Vida - Como Proust pode mudar Sua Vida
Como Proust Pode Mudar Sua Vida - Como Proust Pode Mudar Sua Vida
Nocauteado Pelos Meus Nunga-Nungas - Nocauteado Pelos Meus Nunga-Nungas
O fim da história e o último homem - O fim da história e o último homem
A melhor história está por vir - A melhor história está por vir
Os Anjos de Badaró - Os Anjos de Badaró
Sonhos em Flor - Sonhos em Flor
A Bíblia do diabo - A Bíblia do diabo
O Homem que comeu o 747 - O Homem que comeu o 747
Meu nome é maldade - Meu nome é maldade
Amor em Dose Dupla - Amor em Dose Dupla
O jantar da lagartixa - O jantar da lagartixa
A festa de aniversário - A festa de aniversário
Nunca Diga Adeus - Nunca Diga Adeus
Absurdistão - Absurdistão
A Fábrica de Sonhos da Pixar - A Fábrica de Sonhos da Pixar
Querido diário, eu morri - Querido diário, eu morri
As aventuras do menino Jesus - As aventuras do menino Jesus
As Treze Relíquias - As Treze Relíquias
Muncle Trogg: O menor gigante do mundo - Muncle Trogg: O menor gigante do mundo
Adeus, Princesa - Adeus, Princesa
O Clube do Terror - O Clube do Terror
O homem da Chuva - O homem da Chuva
Um Coração Singelo - Um Coração Singelo
Bellini e a Esfinge - Bellini e a Esfinge
Em Busca do Príncipe Encantado - Em Busca do Príncipe Encantado
O Testamento do Trovador - O Testamento do Trovador
Desenvolva a Sua Capacidade de Liderança - Desenvolva a Sua Capacidade de Liderança
O aprendizado da srta. Beatrice Hempel - O aprendizado da srta. Beatrice Hempel
Entre a Cruz e o Arco-Íris - Entre a Cruz e o Arco-Íris
Homem-Máquina  - Homem-Máquina 
O Túmulo da Borboleta - O Túmulo da Borboleta
A primeira impressão é a que fica - A primeira impressão é a que fica
A Compacta História do Mundo (Vol. 1) - A Compacta História do Mundo (Vol. 1)
Herança de Sangue - Herança de Sangue
Clube do Beijo - Clube do Beijo
O Amigo Invisível - O Amigo Invisível
Esperando o amor chegar - Esperando o amor chegar
O Paraíso dos Ogros - O Paraíso dos Ogros
O Poder Verdadeiro - O Poder Verdadeiro
Anita Garibaldi - Anita Garibaldi
O Garoto que Comeu a Rua do Medo - O Garoto que Comeu a Rua do Medo
Mulheres Inteligentes, Escolhas Insensatas - Mulheres Inteligentes, Escolhas Insensatas
Guia de Caça e Pesca para Mulheres - Guia de Caça e Pesca para Mulheres
O Brado de Halidon - O Brado de Halidon
O Primeiro A Gente Nunca Esquece - O Primeiro A Gente Nunca Esquece
Hoje Acordei Gorda - Hoje Acordei Gorda
Uma Escolha Imperfeita - Uma Escolha Imperfeita
O Baile da Vitória - O Baile da Vitória
O Dia da Coruja - O Dia da Coruja
O Sabá das Feiticeiras - O Sabá das Feiticeiras
Eu Fui A Espiã Que Amou O Comandante - Eu Fui A Espiã Que Amou O Comandante
A Compacta História do Mundo (Vol. 3) - A Compacta História do Mundo (Vol. 3)
Contos de Fadas Norte-Americanos - Contos de Fadas Norte-Americanos
Por Que Os Homens Têm Medo de Compromisso? - Por Que Os Homens Têm Medo de Compromisso?
A Compacta História do Mundo (Vol. 2) - A Compacta História do Mundo (Vol. 2)
A filha de Burger - A filha de Burger
Unidos do Outro Mundo - Unidos do Outro Mundo
O Colapso de Tudo  - O Colapso de Tudo 
Aprendendo a Conviver com Quem se Ama - Aprendendo a Conviver com Quem se Ama
Sobre a capacidade de amar de outros assuntos poéticos - Sobre a capacidade de amar de outros assuntos poéticos
A Ponte dos Judeus - A Ponte dos Judeus
Os incríveis infortúnios de um escritor aprendiz - Os incríveis infortúnios de um escritor aprendiz
Espiritualidade para corajosos - Espiritualidade para corajosos
Três Viúvas - Três Viúvas
Vamos matar a professora de medo! - Vamos matar a professora de medo!
Lições sobre amar e viver - Lições sobre amar e viver
O Abominável Homem das Neves - O Abominável Homem das Neves
101 experiências de filosofia cotidiana - 101 experiências de filosofia cotidiana
Pelé, a Autobiografia - Pelé, a Autobiografia
Os Anos Perdidos de Jesus - Os Anos Perdidos de Jesus
Eu odeio meu chefe? (Capa Dura) - Eu odeio meu chefe? (Capa Dura)
Sociedades Secretas - Templários - Sociedades Secretas - Templários
Pela boca da baleia - Pela boca da baleia
Sociedades Secretas - Templários  - Sociedades Secretas - Templários 
Não Faça Tempestade em Copo D'água no Trabalho - Não Faça Tempestade em Copo D'água no Trabalho
Etiqueta sem frescura - Etiqueta sem frescura
As Vozes do Coração - As Vozes do Coração
A Cidade dos Hereges - A Cidade dos Hereges
A esperança tem muitas faces - A esperança tem muitas faces
Viagem ao Fundo do Mar - Viagem ao Fundo do Mar
O CLÃ DOS PETER PANS - O CLÃ DOS PETER PANS
Enigmas do Cristianismo - Enigmas do Cristianismo
A última testemunha - A última testemunha
Sociedades Secretas - Edição de Luxo - Sociedades Secretas - Edição de Luxo
Maçonaria para não-iniciados - Maçonaria para não-iniciados
Os amantes de Estocolmo - Os amantes de Estocolmo
Razão e Sensibilidade e Monstros Marinhos - Razão e Sensibilidade e Monstros Marinhos
O Abominável Monstro das Neves - O Abominável Monstro das Neves
Meninos valentes - Meninos valentes
O cavaleiro do medo - O cavaleiro do medo
As 5 melhores maneiras de se conseguir um emprego - As 5 melhores maneiras de se conseguir um emprego
As Regras do Amor - As Regras do Amor
O retorno dos cátaros - O retorno dos cátaros
Tem um Fantasma no Banheiro dos Meninos - Tem um Fantasma no Banheiro dos Meninos
Histórias de Mistério - Histórias de Mistério
A Gaiola Dourada - A Gaiola Dourada
Como vencer quando você não é o favorito - Como vencer quando você não é o favorito
Um Instante de Felicidade - Um Instante de Felicidade
Despedida em Veneza - Despedida em Veneza
O que Steve Jobs faria? - O que Steve Jobs faria?
As Oito Montanhas - As Oito Montanhas
Por que os homens casam com as mulheres poderosas? - Por que os homens casam com as mulheres poderosas?
A Princesa Perdida - A Princesa Perdida
Como se defender de ataques verbais - Como se defender de ataques verbais
Poseur - Brigas, Garotos e Estilo - Poseur - Brigas, Garotos e Estilo
Sociedades Secretas  - Sociedades Secretas 
Caderno de rabiscos para adultos que querem chutar o balde - Caderno de rabiscos para adultos que querem chutar o balde
Como se defender de manipuladores - Como se defender de manipuladores
O Homem Terminal - O Homem Terminal
Amanhã Eu Paro! - Amanhã Eu Paro!
Por que os Homens Se Casam com Algumas Mulheres e Não com Outras? - Por que os Homens Se Casam com Algumas Mulheres e Não com Outras?
A Arte da Meditação - A Arte da Meditação
A ARTE DA MEDITAÇÃO - A ARTE DA MEDITAÇÃO
A arte da meditação - A arte da meditação
Farsa de Inês Pereira; Auto da Barca do Inferno; Auto da Alma; Pranto de Maria Parda - Farsa de Inês Pereira; Auto da Barca do Inferno; Auto da Alma; Pranto de Maria Parda
Isto Não É Um Livro - Isto Não É Um Livro
Nove Plantas do Desejo e a Flor de Estufa - Nove Plantas do Desejo e a Flor de Estufa
Quantic Love - Quantic Love
O segredo da plataforma 13 - O segredo da plataforma 13
Já Disse Que Te Amo? - Já Disse Que Te Amo?
A Matilha das Herdeiras - A Matilha das Herdeiras
Matilda do osso - Matilda do osso
Como Motivar Sua Equipe - Como Motivar Sua Equipe
Caça-fantasmas brasileiros - Caça-fantasmas brasileiros
Como se tornar mais organizado e produtivo - Como se tornar mais organizado e produtivo
A instrução dos amantes - A instrução dos amantes
Areia nos Dentes - Areia nos Dentes
AS CASADAS DE PROSPECT PARK WEST - AS CASADAS DE PROSPECT PARK WEST
Amor Esquartejado - Amor Esquartejado
Viagem ao fundo da sala - Viagem ao fundo da sala
Caixa Preta - Caixa Preta
Shakespeare para apaixonados - Shakespeare para apaixonados
O jogo de Calder - O jogo de Calder
As Irmãs Sloane  - As Irmãs Sloane 
Seu Balde Está Cheio? - Seu Balde Está Cheio?
Se o Colégio é um Jogo, Estas São as Regras a Violar - Se o Colégio é um Jogo, Estas São as Regras a Violar
Valsa Negra - Valsa Negra
O Jogo das Sombras - O Jogo das Sombras
Bruxas, Bruxos e Os Feitiços Mais Cruéis Que Se Podem Imaginar - Bruxas, Bruxos e Os Feitiços Mais Cruéis Que Se Podem Imaginar
Guia de Uma Ciclista em Kashgar - Guia de Uma Ciclista em Kashgar
Homem Bom é Homem Morto - Homem Bom é Homem Morto
O Manual do Novo Gerente - O Manual do Novo Gerente
Antes da Queda - Antes da Queda
A Sombra da Lua - A Sombra da Lua
Pare de beijar sapos! - Pare de beijar sapos!
A Rebelião de Lúcifer - A Rebelião de Lúcifer
O esqueleto no skate  - O esqueleto no skate 
A Nova Lei de Murphy - A Nova Lei de Murphy
O terceiro anjo - O terceiro anjo
Lago dos Sonhos - Lago dos Sonhos
manual do mané - manual do mané
Os Segredos do Código - Os Segredos do Código
Era Uma Vez Um Corredor - Era Uma Vez Um Corredor
O Ataque dos Macacos - O Ataque dos Macacos
Os Crimes da Luz - Os Crimes da Luz
Os Melhores Contos Orientais - Os Melhores Contos Orientais
O Diabo de Milão  - O Diabo de Milão 
A história secreta das meninas tempestivas - A história secreta das meninas tempestivas
A Dama Azul - A Dama Azul
Os 100 Segredos das Pessoas de Sucesso - Os 100 Segredos das Pessoas de Sucesso
A sabedoria de Tyrion Lannister - A sabedoria de Tyrion Lannister
O ÚLTIMO MEROVÍNGIO - O ÚLTIMO MEROVÍNGIO
50 noites em tons de cinza - 50 noites em tons de cinza
99 filmes clássicos para apressadinhos - 99 filmes clássicos para apressadinhos
Os Noventa Dias de Geneviève - Os Noventa Dias de Geneviève
A Libertação da Bela - A Libertação da Bela
O Gaúcho - O Gaúcho
Faça o que tem de ser feito - Faça o que tem de ser feito
O Mundo Mágico do Senhor dos Anéis - O Mundo Mágico do Senhor dos Anéis
Garota Quase 15 anos, Paquerando pela Inglaterra - Garota Quase 15 anos, Paquerando pela Inglaterra
O Constante Correr das Horas - O Constante Correr das Horas
Homens São de Marte, Mulheres São de Vênus - Livro dos Dias - Homens São de Marte, Mulheres São de Vênus - Livro dos Dias
Não Coma da Carne Misteriosa - Não Coma da Carne Misteriosa
Deixe os homens aos seus pés - Deixe os homens aos seus pés
Sociedades Secretas - Sociedades Secretas
A Dieta de South Beach - A Dieta de South Beach
Os 100 Segredos dos Bons Relacionamentos - Os 100 Segredos dos Bons Relacionamentos
O superblog das maravilhosas: Mari, Luma e Carol - O superblog das maravilhosas: Mari, Luma e Carol
O Fedor dos Anéis - O Fedor dos Anéis
Deus foi almoçar  - Deus foi almoçar 
Coisas Inatingíveis - Coisas Inatingíveis
Kama Sutra XXX - Kama Sutra XXX
Kama sutra XXX - Kama sutra XXX
A Punição da Bela - A Punição da Bela
Leitura dinâmica para principiantes - Leitura dinâmica para principiantes
No Início Não Havia Bob - No Início Não Havia Bob
Homens Gostam de Mulheres Que Gostam de Si Mesmas - Homens Gostam de Mulheres Que Gostam de Si Mesmas
A Mulher Perfeita É Uma Vaca - A Mulher Perfeita É Uma Vaca
Axolotle Atropelado - Axolotle Atropelado
Os Crimes do Mosaico - Os Crimes do Mosaico
Linda, Como no Caso do Assassinato de Linda  - Linda, Como no Caso do Assassinato de Linda 
Os Criminosos de Novembro - Os Criminosos de Novembro
